a.envisionmobile.caa	CAA	Lifestyle
air.au.com.metro.DumbWaysToDie	Dumb Ways to Die	Casual
air.au.com.metro.DumbWaysToDie2	Dumb Ways to Die 2: The Games	Casual
air.au.com.minimega.bonza	Bonza Word Puzzle	Word
air.Beautifulbridedressup	Beautiful bride dressup	Family
air.br.com.bitlabs.FLVPlayer	FLV Video Player	Media & Video
air.byss.mobi.instaweatherfree	InstaWeather	Weather
air.cn.kx.yttxgoogleTwbattle	三國志跨海國戰-伍佰推薦	Strategy
air.com.A3dtuning.Tuning3D	3D Tuning	Entertainment
air.com.adobe.connectpro	Adobe Connect	Business
air.com.bigfishgames.fairwayrevengegooguniversalf2p	Fairway Solitaire Blast	Card
air.com.bigfishgames.fairwaysolitaire2.google	Fairway Solitaire!	Card
air.com.bitrhymes.bingo	Bingo Bash	Casino
air.com.buffalo_studios.newflashbingo	BINGO Blitz - FREE Bingo+Slots	Casino
air.com.disney.hiddendisney.goo	Disney Hidden Worlds	Casual
air.com.dryginstudios.bioinc	Bio Inc. - Biomedical Plague	Simulation
air.com.ea.game.monopolyslots_na	MONOPOLY Slots	Casino
air.com.freshplanet.games.MoviePop	MoviePop	Trivia
air.com.freshplanet.games.WaM	SongPop	Music
air.com.g5e.bravetribe	Brave Tribe	Strategy
air.com.games2win.bffhsfashion	BFF - High School Fashion	Role Playing
air.com.games2win.fashionlovestory	High School Love Story	Role Playing
air.com.gamesys.mobile.slots.jpj	Jackpotjoy Slots	Casino
air.com.generamobile.colormaniaguess	Colormania - Guess the Colors	Trivia
air.com.gerwinsoftware.superbuzzer	Superbuzzer Quiz Game	Trivia
air.com.goodgamestudios.empirefourkingdoms	Empire: Four Kingdoms	Strategy
air.com.ludia.tpirbingo	The Price Is Right™ Bingo	Casino
air.com.mediawix.CultureQuizz	Culture Quizz	Trivia
air.com.mobigrow.canyouescape	Can You Escape	Puzzle
air.com.moviestarplanet.boonieverse	Boonie Planet	Role Playing
air.com.noxgames.PuppetHockey	Puppet Ice Hockey: 2014 Cup	Sports
air.com.oranginalplan.weaphonesfree	Weaphones™ Gun Sim Free Vol 1	Simulation
air.com.oranginalplan.weaphonesvol2free	Weaphones™ Gun Sim Free Vol 2	Simulation
air.com.pearsoned.poptropica	Poptropica	Adventure
air.com.peppapig.paintbox	Peppa's Paintbox	Educational
air.com.perfectworld.ek	Elemental Kingdoms (CCG)	Card
air.com.playtika.slotomania	Slotomania - FREE Slots Games	Casino
air.com.puffballsunited.escapingtheprison	Escaping the Prison	Casual
air.com.qublix.wordwizards	Word Wizards	Word
air.com.rosettastone.mobile.CoursePlayer	Learn Languages: Rosetta Stone	Education
air.com.sanuk.KhoTesting1	Fame City	Simulation
air.com.sgn.bookoflife.gp	Book of Life: Sugar Smash	Puzzle
air.com.sgn.cookiejam.gp	Cookie Jam	Puzzle
air.com.slotgalaxy	Slot Galaxy Free Slot Machines	Casino
air.com.starfall.more	Starfall FREE	Education
air.com.tensquaregames.letsfish	Let's Fish: Sport Fishing	Simulation
air.com.toystudio.casinotower	Casino Tower ™ - Slot Machines	Casino
air.com.tutotoons.app.babyhouse	Sweet Baby Girl - Dream House	Family
air.com.ubisoft.csi.HiddenCrimes	CSI: Hidden Crimes	Puzzle
air.com.videotron.illico.player	illico.tv Plugin	Media & Video
air.com.webkinz.webkinzmobile	Webkinz™	Family
air.com.youdagames.google.ww.gop2MobileFree	Governor of Poker 2 - HOLDEM	Card
air.com.youtogame.dragonhd	Legend of Dragon-HD	Role Playing
air.com.yudu.ReaderAIR4377373	CPA Magazine	Business
air.DroidBall	ButtonBeats Dubstep Balls	Music
air.DubstepCube	ButtonBass Dubstep Cube	Music
air.EDMCUBE	ButtonBass EDM Cube	Music
air.EDMCUBE2	ButtonBass EDM Cube 2	Music
air.fisherprice.com.animalsounds	Animal Sounds for Baby	Education
air.fisherprice.com.Puppy	Learning Letters Puppy	Education
air.fisherprice.com.shapesAndColors	Shapes & Colors Music Show	Education
air.HardTime	Hard Time (Prison Sim)	Adventure
air.ie.capture.fisherprice	Storybook Rhymes Volume 1	Books & Reference
air.infurerpgkuesuto	Inflation RPG	Role Playing
air.MSPMobile	MovieStarPlanet	Simulation
air.MSPTablet	MovieStarPlanet HD	Simulation
air.mwe.cookingcuteheartcupcakes	Bake Cupcakes - Cooking Games	Casual
air.net.lol.genioquiz	Genius Quiz	Trivia
air.net.m7g7.MermaidBathing	mermaid bathing girls games	Family
air.net.playzio.cartoonsquiz	Cartoons Quiz - Ultimate	Trivia
air.nn.mobile.app.main	NeuroNation - brain training	Education
air.org.axisentertainment.BabyHazelDentalCare	Baby Hazel Dental Care	Educational
air.org.axisentertainment.BabyHazelLegInjury	Baby Hazel Leg Injury	Educational
air.Popscene	Popscene (Music Industry Sim)	Music
air.WR3DFree	Wrestling Revolution 3D	Sports
airborne.nhlwp	NHL 2015 Live Wallpaper	Sports
aiy.lwh.games.mine	WorldCraft : Craft & Survival	Adventure
alpha.aquarium.hd.livewallpaper	The real aquarium - HD	Personalisation
an.SpanishTranslate	Spanish english translator	Books & Reference
another.music.player	Shuttle Music Player	Music & Audio
answers.appgeeks.emoji	Guess The Emoji Answers	Trivia
aplicacion.tiempo	Weather 14 days	Weather
app.WTInfoTech.WorldAroundMeLite	WAM - World Around Me Lite	Travel & Local
appinventor.ai_progetto2003.SCAN	QR BARCODE SCANNER	Tools
appinventor.ai_ryan3018.MLG_Soundboard	MLG Soundboard	Entertainment
at.markushi.expensemanager	Expense Manager	Finance
au.com.oddgames.monstertruckdestruction	Monster Truck Destruction™	Racing
au.com.penguinapps.android.babyfeeding.client.android	Feed Baby - Tracker & Monitor	Medical
au.com.penguinapps.android.babyphone	Baby Phone Game for Babies	Family
banamalon.teatime	Tea Time!	Lifestyle
bbc.mobile.news.ww	BBC News	News & Magazines
bbc.mobile.sport.ww	BBC Sport	Sports
beyond.translinkbustracker	TransLink Bus Tracker	Transport
biz.bookdesign.librivox	LibriVox Audio Books Free	Books & Reference
biz.mtoy.blockpuzzle.revolution	Block Puzzle	Puzzle
books.ebook.pdf.reader	EBook Reader & PDF Reader	Books & Reference
br.com.blackmountain.mylook	Photo Editor	Photography
br.com.brainweb.ifood.pizzahut	Pizza Hut	Shopping
br.com.rodrigokolb.classicdrum	Classic Drum	Music
br.com.rodrigokolb.dubstepbeatz	Dubstep Pads	Music
br.com.rodrigokolb.electropads	Electro Pads	Music
br.com.rodrigokolb.hiphopbeatz	Hip Hop Pads	Music
br.com.rodrigokolb.realbass	Real Bass	Music
br.com.rodrigokolb.realdrum	Real Drum	Music
br.com.rodrigokolb.realguitar	Real Guitar	Music
br.com.rodrigokolb.realpiano	Real Piano	Music
br.com.rodrigokolb.tabla	Tabla	Music
br.com.tapps.cowevolution	Cow Evolution - Clicker Game	Casual
br.com.tapps.myboo	My Boo - Your Virtual Pet Game	Educational
br.com.tapps.mybooalbum	My Boo Album - Sticker Book	Educational
br.com.tapps.picopets	Pico Pets - Monster Battle	Role Playing
ca.autotrader.userapp	autoTRADER.ca - Auto Trader	Lifestyle
ca.bell.fiberemote	Bell Fibe Remote	Entertainment
ca.bell.selfserve.mybellmobile	MyBell Mobile	Tools
ca.bellmedia.bnngo	BNN GO	Finance
ca.bellmedia.cp24	CP24 GO	News & Magazines
ca.bellmedia.cravetv	CraveTV	Entertainment
ca.bellmedia.ctvnews	CTV News GO	News & Magazines
ca.blood.giveblood	GiveBlood	Medical
ca.bnc.android	National Bank Application	Finance
ca.capitalone.enterprisemobilebanking	Capital One Canada	Finance
ca.carpages.carpagesconsumer	Carpages.ca - Used Cars Canada	Lifestyle
ca.cbc.mobile.android.cbcnewsandroidwebview	CBC News	News & Magazines
ca.centennialcollege.centmobile	Centennial College	Education
ca.crea.realtor	REALTOR.ca	Lifestyle
ca.ctv.ctvgo	CTV GO	Entertainment
ca.dominospizza	Domino's Pizza Canada	Lifestyle
ca.edmonton.etslive	ETS Live® To Go	Transport
ca.fwe.caweather	Canada Weather & Radar	Weather
ca.gwl.group.groupnet	GroupNet Mobile	Finance
ca.indigo	Indigo	Shopping
ca.lapresse.android.lapressemobile	La Presse Mobile	News & Magazines
ca.lapresse.lapresseplus	La Presse+	News & Magazines
ca.manulife.android	Group Benefits Mobile	Finance
ca.medavie.mobile	Medavie Blue Cross Mobile	Medical
ca.medeo.android	Medeo	Medical
ca.metronews.Metro	Metro News Canada	News & Magazines
ca.qc.gouv.mtq.Quebec511	Québec 511	Transport
ca.save.m	Save.ca - Flyers & Cash-Back	Shopping
ca.sears.mobile	Sears Canada	Shopping
ca.superecrango	Super Écran GO	Media & Video
ca.tangerine.clients.phone	Tangerine Banking	Finance
ca.tangerine.clients.tablet	Tangerine Banking (Tablet)	Finance
ca.tmngo	The Movie Network GO	Media & Video
ca.transcontinental.android.shoppers.sdm	Shoppers Drug Mart	Health & Fitness
ca.tsn.mobile.android	TSN GO	Sports
ca.tuango.android	Tuango Mobile	Shopping
ca.virginmobile.myaccount.virginmobile	Virgin Mobile My Account	Lifestyle
ca.windmobile.selfcare.prod	WIND My Account	Tools
cat.minkusoft.jocstauler	Board Games	Board
ch.bitspin.timely	Timely Alarm Clock	Lifestyle
ch.threema.qrscannerplugin	Threema QR Scanner Plugin	Libraries & Demo
chat.sebastian.uno	UNO Game Free	Card
cmm.liwenwen.ship.leaf	s4 nature boat theme wallpaper	Libraries & Demo
cmm.liwenwen.star.fly	fly star live wallpaper	Libraries & Demo
cn.jingling.motu.photowonder	PhotoWonder	Photography
cn.wps.moffice_eng	WPS: #1 FREE Mobile Office App	Business
co.happybits.anyvideo.kik	Video Kik	Media & Video
co.romesoft.toddlers.puzzle.truck	Vehicles Puzzles for Toddlers!	Educational
co.touchlab.android.onesecondeveryday	1 Second Everyday	Media & Video
co.vine.android	Vine	Widgets
com.aa.generaladaptiveapps	aa	Strategy
com.aadhk.time	Timesheet - Work Time Tracker	Business
com.abc.resfree	Super Resume Builder, CV	Business
com.academmedia.BattleshipWar3D	Battleship War 3D	Board
com.accurate.weather.widget	Weather & Widgets	Weather
com.accuweather.android	AccuWeather	Widgets
com.ace.force	파워레인저 엔진포스 다시보기	Comics
com.aceviral.angrygranrun	Angry Gran Run - Running Game	Racing
com.acmeaom.android.myradar	MyRadar Weather Radar	Weather
com.actionmobile.ocarinaoftime	Ocarina of Time	Music
com.activision.callofduty.heroes	Call of Duty®: Heroes	Action
com.activision.codm2	Call of Duty: Advanced Warfare	Entertainment
com.activision.wipeout2	Wipeout 2	Action
com.ad60.songza	Songza	Widgets
com.adn37.omegleclientlite	Omegle Android FREE	Communication
com.adobe.air	Adobe AIR	Widgets
com.adobe.psmobile	Adobe Photoshop Express	Photography
com.adobe.reader	Adobe Reader	Productivity
com.adpmobile.android	ADP Mobile Solutions	Business
com.adpog.diary	Diary notes - with lock	Lifestyle
com.adsk.sketchbookhdexpress	SketchBook Express	Media & Video
com.aerilys.acr.android	Astonishing Comic Reader	Comics
com.agminstruments.drumpadmachine	Drum Pad Machine	Music & Audio
com.aiadp.resquiz	Guess the Restaurant Quiz	Trivia
com.aidenhemmantst.tv.remote.control	Remote Control for TV	Tools
com.aim.racing	Extreme Car Driving Simulator	Racing
com.airbnb.android	Airbnb	Travel & Local
com.AirCanadaApp	Air Canada	Travel & Local
com.airlinemates.yahtzee	Yahtzee! Free	Strategy
com.airmiles	AIR MILES® Reward Program	Lifestyle
com.airwatch.androidagent	AirWatch MDM Agent	Business
com.airwatch.browser	AirWatch Browser	Business
com.aitype.android	ai.type keyboard FREE + Emoji	Productivity
com.akasoft.topplaces	Restaurant Finder	Travel & Local
com.alarmclock.xtreme.free	Alarm Clock Xtreme Free +Timer	Tools
com.albocal.faketosnapchat	Media for Snaps	Social
com.aldiko.android	Aldiko Book Reader	Books & Reference
com.alegrium.iconpopsong	Icon Pop Song	Trivia
com.alensw.PicFolder	QuickPic	Photography
com.alibaba.aliexpresshd	AliExpress Shopping App	Shopping
com.alibaba.intl.android.apps.poseidon	Alibaba.com	Business
com.alkalinelabs.learnguitarchords	Learn Guitar Chords	Education
com.alldigital.rogers.pdvr.android	Anyplace TV Home Mobile (ON)	Media & Video
com.allrecipes.spinner.free	Allrecipes Dinner Spinner	Lifestyle
com.allso.risewarsads	Rise Wars (Risk game) Free	Strategy
com.alokmandavgane.sunrisesunset	Sunrise Sunset	Weather
com.alpinereplay.android	Trace Snow Ski Snowboard Track	Sports
com.amazon.kindle	Kindle	Widgets
com.amazon.mShop.android.shopping	Amazon Shopping	Shopping
com.amazon.windowshop	Amazon for Tablets	Shopping
com.amuniversal.android.gocomics	GoComics	Comics
com.AnatomyLearning.Anatomy3DViewer3	AnatomyLearning - 3D Atlas	Medical
com.ancestry.android.apps.ancestry	Ancestry	Books & Reference
com.anddoes.launcher	Apex Launcher	Personalisation
com.andersonsolutions.weathertime	Weather Time for Wear	Weather
com.androbros.puzzle2048eng	2048	Puzzle
com.androidcentral.app	AC App for Android™	News & Magazines
com.androiddevelopermx.blogspot.bones3d	Bones Human 3D (anatomy)	Medical
com.androiddevelopermx.blogspot.organos3d	Organs 3D (Anatomy)	Medical
com.androidity.wallpaper.funny2	funny backgrounds jokes	Comics
com.androidwasabi.livewallpaper.g3	Smoke Live Wallpaper	Personalisation
com.andromo.dev136619.app205267	Top 100 Free Funny Ringtones	Personalisation
com.andromo.dev230101.app249724	Quote Wallpaper	Lifestyle
com.andromo.dev230101.app312270	Hipster Wallpapers	Lifestyle
com.andropenoffice	AndrOpen Office	Business
com.androvid	AndroVid Video Editor	Media & Video
com.andrwq.recorder	Smart Voice Recorder	Music & Audio
com.anilvasani.myttc	My TTC - Toronto Transit	Transport
com.animoca.google.starGirlBeautyQueen	Star Girl: Beauty Queen	Role Playing
com.animoca.google.starGirlChristmas	Star Girl: Christmas	Music
com.animoca.google.starGirlPrincess	Star Girl: Princess Gala	Role Playing
com.ansangha.drchess	Dr. Chess	Board
com.ansangha.drdriving	Dr. Driving	Racing
com.antivirus	AntiVirus Security - FREE	Communication
com.antivirus.tablet	Tablet AntiVirus Security FREE	Productivity
com.anydo	Any.do Task List & To-do List	Productivity
com.anyoption.android.app	anyoption - Binary Options	Finance
com.anysoftkeyboard.languagepack.hebrew	Hebrew Language Pack	Libraries & Demo
com.apalon.myclockfree	My Alarm Clock Free	Tools
com.apalon.weatherlive.free	Weather Live with Widgets Free	Live Wallpaper
com.apexappsdmcc.spottheshade	Shade Spotter	Puzzle
com.apostek.SlotMachine	Slot Machine - FREE Casino	Casino
com.app.free.studio.firefly.locker	Fireflies lockscreen	Live Wallpaper
com.apperto.piclabapp	PicLab - Photo Editor	Photography
com.appficient.iclicker	i>clicker GO	Education
com.appgame7.candyfrenzy	Candies Frenzy	Casual
com.appgame7.candyfrenzy2	Candies Frenzy 2	Casual
com.appheaven.slender.man.game.free	Slender Man	Adventure
com.appkruti.crazyheliumboothlite	Crazy Helium Video Booth Lite	Entertainment
com.appnana.android.giftcardrewards	AppNana - Free Gift Cards	Shopping
com.appon.mancala	Mancala	Board
com.appquiz.educational.games	Educational games for kids	Educational
com.appraton.musictube	Music Tube	Music & Audio
com.appsbeyond.countdownplus.lite	Countdown Plus Widgets Lite	Lifestyle
com.appspot.swisscodemonkeys.paintfx	Splash Colour Effects	Photography
com.appsverse.photon	Photon Flash Player & Browser	Communication
com.appturbo.appturboCA	App of the Day (CA) -100% Free	Lifestyle
com.appxy.tinyscanfree	Tiny Scan:PDF Document Scanner	Business
com.apusapps.launcher	APUS Launcher-Small,Fast,Boost	Tools
com.apusapps.tools.booster	APUS Booster+|Small, Effective	Productivity
com.apusapps.tools.flashtorch	APUS Flashlight | simple, fun	Personalisation
com.aragosoft.rtcmobile	RTC Mobile	Transport
com.arcsoft.perfect365	Perfect365: One-Tap Makeover	Photography
com.ars.homedesign	Home Design: Dream House	Role Playing
com.ascendo.android.dictionary.fr.free	French English Dictionary	Education
com.asgardsoft.words	Words	Word
com.askfm	Ask.fm - Social Q&A Network	Social
com.asos.app	ASOS	Shopping
com.astarsoftware.euchre	Euchre 3D	Card
com.astral.astralradio	Bell Media Radio	Music & Audio
com.astral.belltalk	Bell Media Talk Radio	News & Magazines
com.astral.virginradio	Virgin Radio Canada	Music & Audio
com.atari.mobile.rct4m	RollerCoaster Tycoon® 4 Mobile	Simulation
com.ati.sthubert	St-Hubert	Shopping
com.atomic.apps.medical.disease.condition.dictionary	Diseases Dictionary ✪ Medical	Medical
com.atomic.apps.medical.drug.dictionary	Drugs Dictionary Offline: FREE	Medical
com.atomic.apps.ringtone.cutter	MP3 Cutter and Ringtone Maker♫	Music & Audio
com.atrilliongames.chessgame	3D Chess Game	Strategy
com.audible.application	Audible for Android	Books & Reference
com.audioguidia.myweather	Weather 5 days	Weather
com.AURORA.UltimateSeaBattle3D	Sea Battle :Warships (3D)	Strategy
com.autobattle.and.eternal	Auto Battle - Legend of Heroes	Strategy
com.autodesk.homestyler	Homestyler Interior Design	Lifestyle
com.avantar.wny	White & Yellow Pages	Shopping
com.avast.android.mobilesecurity	Antivirus & Security	Widgets
com.avg.cleaner	AVG Cleaner & Battery booster	Tools
com.avg.privacyfix	PrivacyFix for Social Networks	Social
com.aviary.android.feather	Photo Editor by Aviary	Photography
com.aviary.android.feather.plugins.borders.free	Aviary Frames: Original	Libraries & Demo
com.aviary.android.feather.plugins.filters.original	Aviary Effects: Classic	Libraries & Demo
com.aviary.android.feather.plugins.stickers.free_stickers	Aviary Stickers: Free Pack	Libraries & Demo
com.aviary.android.feather.plugins.stickers.space	Aviary Stickers: Space	Libraries & Demo
com.avidionmedia.iGunHD	iGun Pro -The Original Gun App	Arcade
com.avisinna	RocketMan Transit + Bixi Bikes	Transport
com.awestruck.poke	Pokedex - Dexter	Books & Reference
com.aws.android	WeatherBug	Weather
com.AyikanApp.fivenightsinfear	Five Nights in Fear	Arcade
com.azarlive.android	Azar-Video Chat&Call,Messenger	Communication
com.b3connect.dmf.client.android.boston	Boston Bruins Official App	Sports
com.babbel.mobile.android.en	Babbel – Learn Languages	Education
com.babycenter.pregnancytracker	My Pregnancy Today	Health & Fitness
com.backflipstudios.android.dragonvale	DragonVale	Family
com.badoo.mobile	Badoo - Meet New People	Widgets
com.baileyz.aquarium	Fish Live	Family
com.baiwang.instablend	BlendPic:Blend photo	Photography
com.baiwang.instaface	InstaFace:face eyes morph	Photography
com.bald.selfie	#NoHairSelfie	Lifestyle
com.BaliCheckers.Checkers	Checkers Online	Board
com.balloonisland.ultimatejewel	Ultimate Jewel	Board
com.baloota.dumpster	Dumpster Image & Video Restore	Productivity
com.bambuna.podcastaddict	Podcast Addict	Media & Video
com.bamnetworks.mobile.android.gameday.atbat	MLB.com At Bat	Sports
com.bandsintown	Bandsintown Concerts	Music & Audio
com.barbie.fdm	Barbie Fashion Design Maker	Family
com.baseapp.eyeem	EyeEm - Camera & Photo Filter	Photography
com.bau.speedtrafficracer	Cars: Traffic Racer	Racing
com.baviux.pillreminder	Lady Pill Reminder	Medical
com.baviux.voicechanger	Voice changer with effects	Family
com.bbm	BBM	Communication
com.beansprites.babymommycare	Newborn Baby & Mommy Care FREE	Educational
com.beansprites.schoollunchmaker	School Lunch Maker	Educational
com.bearhugmedia.android_barbiehairsalon	Fashion Doll Makeover! - SPA	Family
com.bearhugmedia.android_beautysalon2	Beauty Hair Salon: Fashion SPA	Family
com.beatronik.djstudiodemo	DJ Studio 5 - Free music mixer	Music & Audio
com.bendigi.Mortgage	Canadian Mortgage App	Business
com.bepop.bepop	Like4Like: Get Instagram Likes	Social
com.berniiiiiiii.crossword	Crossword	Word
com.berniiiiiiii.motscroises	Mots Fléchés en Français	Word
com.berobo.android.scanner	Police Scanner Radio Scanner	Entertainment
com.bestcoolfungames.antsmasher	Ant Smasher, Best Free Game	Arcade
com.bestgame.climb	Up Hill Racing: Hill Climb	Racing
com.bestringtonesapps.freeringtonesforandroid	Free Ringtones for Android™	Music & Audio
com.bestringtonesapps.funnysayingsringtones	Funny Sayings Ringtones	Music & Audio
com.bestringtonesapps.popularringtones	Popular Ringtones	Music & Audio
com.bestweatherfor.bibleoffline_pt_ra	Bible Offline	Books & Reference
com.bettertomorrowapps.camerablockfree	Camera Block -Anti spy-malware	Libraries & Demo
com.beyondinfinity.tetrocrate	TetroCrate 3D: Block Puzzle	Board
com.beyondtherack.btrandroid	Beyond the Rack	Shopping
com.bfs.papertoss	Paper Toss	Casual
com.bianor.ams	Flipps - Movies, Music & TV	Media & Video
com.bible.kids	Bible for Kids	Education
com.bigbluebubble.mypompom	My PomPom	Family
com.bigbluebubble.singingmonsters.full	My Singing Monsters	Simulation
com.bigduckgames.flow	Flow Free	Puzzle
com.bigduckgames.flowbridges	Flow Free: Bridges	Puzzle
com.bigfishgames.gummydropgoogle	Gummy Drop!	Casual
com.biggu.shopsavvy	ShopSavvy Barcode Scanner	Shopping
com.bigherostick.frogapp	Big Hero Stick	Casual
com.binubo.citizenshiptest	Canadian Citizenship Test	Education
com.bitbox.dailyfunny	Daily Funny	Comics
com.bitsmedia.android.muslimpro	Muslim Pro - Azan,Quran,Qibla	Lifestyle
com.bitstrips.bitstrips	Bitstrips	Entertainment
com.bitstrips.imoji	Bitmoji - Emoji by Bitstrips	Entertainment
com.bittorrent.client	BitTorrent®- Torrent Downloads	Media & Video
com.blackberry.bbm.meetings	BBM Meetings	Business
com.blackboard.android	Blackboard Mobile Learn™	Education
com.bleacherreport.android.teamstream	Team Stream by Bleacher Report	Sports
com.blizzard.wtcg.hearthstone	Hearthstone Heroes of Warcraft	Card
com.bloomberg.android	Bloomberg for Smartphone	Finance
com.bloomberg.android.plus	Bloomberg+	Finance
com.bluecorner.dontforgetthelyrics2014	Don't Forget the Lyrics 2014	Music
com.bluecorner.totalgym	Total Fitness - Gym Workouts	Health & Fitness
com.bluefirereader	Bluefire Reader	Books & Reference
com.blueoxtech.moxieclassic	Moxie Classic	Word
com.blueoxtech.sevenlittlewords	7 Little Words	Word
com.blueshellgames.luckyslots	Lucky Slots - Free Casino Game	Card
com.bluestar.StreetDunkGlobal	Street Dunk 3 on 3 Basketball	Sports
com.bluetornadosf.smartypants	Skyvi (Siri for Android)	Productivity
com.bmo.investorline	BMO InvestorLine	Finance
com.bmo.mobile	BMO Mobile Banking	Finance
com.bodybuilding.mobile	BodySpace - Social Fitness App	Health & Fitness
com.bonfiremedia.launcher	Aero Launcher - Live Wallpaper	Personalisation
com.booking	Booking.com Hotel Reservations	Travel & Local
com.boreas.snowdaycalculatorsp2	Boreas Snow Day Calculator	Weather
com.box.android	Box	Business
com.brainium.solitairefree	Solitaire	Card
com.brainium.spiderfree	Spider Solitaire	Card
com.brainpop.brainpopfeaturedmovieandroid	BrainPOP Featured Movie	Education
com.bravolang.spanish	Learn Spanish - ES Translator	Books & Reference
com.brighthouse.whitetiles4And	White Tiles 4 : Piano Master	Trivia
com.brokenscreen.crackscreen	Broken Screen - Crack Screen	Casual
com.brother.mfc.brprint	Brother iPrint&Scan	Tools
com.brother.ptouch.sdk	Brother Print Library	Libraries & Demo
com.brst.android.bite.app	Bite BC	Entertainment
com.bsss.gemshooterapken	Smash Stone	Casual
com.bti.myPiano	My Piano	Music & Audio
com.bubblegalaxy.bubble4	Bubble Shooter Galaxy	Casual
com.bubblesoft.android.bubbleupnp	BubbleUPnP UPnP/DLNA	Music & Audio
com.budgestudios.CaillouCheckUp	Caillou Check Up - Doctor	Educational
com.budgestudios.CrayolaNailParty	Crayola Nail Party: Nail Salon	Family
com.budgestudios.GarfieldLivingLarge	Garfield – Living Large!	Family
com.budgestudios.ludorum.chuggington	Chuggington: Kids Train Game	Family
com.budgestudios.StrawberryShortcakeBakeShare	Strawberry Shortcake Bake Shop	Family
com.budgestudios.StrawberryShortcakePuppyPalace	Strawberry Shortcake Puppy	Family
com.budgestudios.StrawberryShortcakeSweetShop	Strawberry Sweet Shop	Family
com.buffstudio.ontheherofree	Buff Knight! - RPG Runner	Role Playing
com.bungieinc.bungiemobile	Destiny	Casual
com.buytopia.snap	Snap by Groupon: Grocery Deals	Shopping
com.buzz.RedLight	Budweiser Red Lights	Sports
com.buzzfeed.android	BuzzFeed	News & Magazines
com.bydsrl.Mahjong	Free Mahjong Games	Board
com.byolegs.couponmichaels	Michaels Coupons	Shopping
com.byril.tictactoe	TicTacToe Online	Board
com.c4cat.dynamix	Dynamix	Music
com.c51	Checkout 51 - Grocery Coupons	Shopping
com.calfordcn.gu	Guns	Action
com.callapp.contacts	CallApp - Caller ID & Block	Communication
com.calm.android	Calm - Meditate, Sleep, Relax	Health & Fitness
com.camera51.android	Camera51 - a smarter camera	Photography
com.camerasideas.instashot	No Crop Video Editor Instagram	Photography
com.camlyapp.Camly	Camly photo editor & collages	Photography
com.campmobile.launcher	dodol Launcher	Personalisation
com.canadapost.android	Canada Post Corporation	Business
com.candyrufusgames.survivalcrafttrial	Survivalcraft Demo	Action
com.caowen.doodlestyle	Doodle Style Theme	Comics
com.capigami.outofmilk	Out of Milk Shopping List	Shopping
com.car2go	car2go	Transport
com.cardcastgame.android.app	Cardcast	Card
com.cardinalblue.piccollage.google	Pic Collage	Photography
com.carlosdelachica.finger	Finger Gesture Launcher	Productivity
com.CarXTech.CarXDriftRacingFull	CarX Drift Racing	Racing
com.cassieapp.ideas.minecraftairplane	Airplane Ideas - Minecraft	Arcade
com.catdaddy.cat22	WWE SuperCard	Sports
com.catdaddy.nba2k15m	MyNBA2K15	Sports
com.caynax.a6w	Abs workout	Health & Fitness
com.cbgs.blockguncraft	Cop Vs Robber- Survival Gun 3D	Simulation
com.cdroid.dominoes	Dominoes	Board
com.centris_mobile	Centris.ca	Shopping
com.cervomedia.spw	Slots - Pharaoh's Way	Casino
com.cf.flightsearch	Cheap Flights – Flight Search	Travel & Local
com.cg.motorbike	Motocross Motorbike Simulator	Racing
com.cg.tennis	3D Tennis	Sports
com.cgmobile.rc	RC Car Hill Racing 3D	Racing
com.cheaptickets	CheapTickets - Cheap is good.	Travel & Local
com.cheerfulinc.flipagram	Flipagram	Photography
com.cheetah.flashlightandroid	Super Bright Flashlight	Tools
com.chess	Chess - Play & Learn	Board
com.chicagoandroid.childrentv	Children TV ~ videos for kids	Comics
com.chillingo.parkingmaniafree.android.ajagplay	Parking Mania	Racing
com.chrome.beta	Chrome Beta	Productivity
com.cibc.android.mobi	CIBC Mobile Banking®	Finance
com.ciegames.RacingRivals	Racing Rivals	Racing
com.cisco.webex.meetings	Cisco WebEx Meetings	Business
com.citc.weather	Eye In Sky Weather	Weather
com.citrix.Receiver	Citrix Receiver	Business
com.citrix.saas.gotowebinar	GoToWebinar	Business
com.citrixonline.android.gotomeeting	GoToMeeting	Business
com.clapfootgames.vtt3dfree	Virtual Table Tennis 3D	Sports
com.classdojo.android	ClassDojo	Education
com.classdojo.student	ClassDojo for Students	Education
com.classicapps.video.chat	Video Calling Free	Media & Video
com.cleanmaster.boost	CM Speed Booster丨Cache Cleaner	Tools
com.cleanmaster.mguard	Clean Master (Speed Booster)	Widgets
com.cleanmaster.security	CM Security Antivirus AppLock	Widgets
com.clear.superfunny	Super Funny Ringtones	Personalisation
com.clinical.quicklabreference	Quick LabRef	Medical
com.cloudmosa.puffinFree	Puffin Web Browser Free	Communication
com.cm.launcher	Cheetah Launcher	Personalisation
com.cmcm.locker	CM Locker(Lock Screen)	Productivity
com.cnn.mobile.android.phone	CNN Breaking US & World News	Widgets
com.coastcapitalsavings.mobileapp	Coast Capital Savings Mobile	Finance
com.codified.hipyard	VarageSale	Shopping
com.coffeebeanventures.easyvoicerecorder	Easy Voice Recorder	Productivity
com.coloring.dora	Coloring pages	Educational
com.coloring.toddlers	Painting and drawing for kids	Educational
com.colortiger.thermo	Smart Thermometer	Tools
com.ColossalStudio.CameraEffects	Photo Effects	Photography
com.com2us.acefishing.normal.freefull.google.global.android.common	Ace Fishing: Paradise Blue	Sports
com.com2us.golfstarworldtour.normal.freefull.google.global.android.common	Golf Star™	Sports
com.com2us.nipb2013.normal.freefull.google.global.android.common	9 Innings: 2014 Pro Baseball	Sports
com.com2us.smon.normal.freefull.google.kr.android.common	Summoners War	Role Playing
com.com2us.soccerspirits.normal2.freefull.google.global.android.common	Soccer Spirits	Card
com.com2us.towerdefense.normal.freefull.google.global.android.common	Tower Defense®	Strategy
com.companyname.MinionPiano	Minion Piano	Music
com.concretesoftware.pbachallenge_androidmarket	PBA® Bowling Challenge	Sports
com.concur.breeze	Concur	Business
com.conducivetech.android.traveler	FlightStats	Travel & Local
com.connectivityapps.hotmail	Connect for Hotmail	Communication
com.contapps.android	Contacts +	Communication
com.contextlogic.geek	Geek - Smarter Shopping	Shopping
com.contextlogic.mama	Mama - Thoughtful Shopping	Shopping
com.contextlogic.wish	Wish - Shopping Made Fun	Shopping
com.cooldatasoft.quiz.applogo	App Logo Quiz	Trivia
com.cootek.smartinputv5	TouchPal -Emoji Keyboard&Theme	Productivity
com.coppi.bestbuy	Best Buy Canada	Shopping
com.coppi.futureshop	Future Shop	Shopping
com.costco.app.android.ca	Costco Canada	Lifestyle
com.couche_tard.android	Couche-Tard	Shopping
com.crack.your.screen.fake	Crack your screen - Fake	Family
com.craftgames.worldcrft	WorldCraft	Arcade
com.craigahart.android.wordgame	Word Game	Word
com.craneballs.gunbuilder2	Gun Master 2	Simulation
com.crazystudio.emoji.kitkat	Emoji Keyboard - CrazyCorn	Tools
com.creactive.quemquersermilionario.fr.lite	Millionnaire Quiz Français	Trivia
com.creativemobile.DragRacing	Drag Racing	Racing
com.creeng.HockeyMVP	Hockey MVP	Sports
com.cremagamesstudios.instant	Instant Buttons	Entertainment
com.crescentmoongames.blocky_roads	Blocky Roads	Racing
com.cribasoft.HoursTrackerFree.Android	Hours Tracker: Time Tracking	Business
com.cricbuzz.android	Cricbuzz Cricket Scores & News	Sports
com.crimsonpine.stayinline	Follow The Line	Casual
com.criticalhitsoftware.policeradio	Police Scanner FREE	News & Magazines
com.crossfield.casinogame_bingo	Bingo	Card
com.crossforward.audiobooks	Audiobooks	Books & Reference
com.crowdstar.covetfashion	Covet Fashion - Shopping Game	Casual
com.crunchyroll.crmanga	Crunchyroll Manga	Comics
com.crunchyroll.crunchyroid	Crunchyroll - Anime and Drama	Entertainment
com.cubefun.funny.jokes.yomomma	YoMomma Jokes 1000+	Comics
com.cyberlink.photodirector	PhotoDirector - Photo Editor	Photography
com.cyberlink.youcammakeup	YouCam Makeup -Makeover Studio	Photography
com.cyberlink.youperfect	YouCam Perfect - Selfie Cam	Photography
com.cybermind.google.superstarFashionGirl	Fashion Girl Power	Role Playing
com.cyo.comicrack.viewer.free	ComicRack Free	Comics
com.cyou.cma.clauncher.theme.v54329a0207ba68625438d848	Golden Apple Theme	Libraries & Demo
com.cyworld.camera	Cymera - Camera& Photo Editor	Photography
com.d3p.mpq	Marvel Puzzle Quest	Puzzle
com.dailyyoga.inc	Daily Yoga - Fitness On-the-Go	Health & Fitness
com.darkhorse.digital	Dark Horse Comics	Comics
com.dataviz.docstogo	Docs To Go™ Free Office Suite	Business
com.datingflirty	Flirt: Online Dating & Chats	Social
com.dayforce.mobile	Dayforce HCM	Business
com.dayspringtech.envelopes	Goodbudget: Expense & Budget	Finance
com.dc.breedingguide	Breeding Guide for Dragon City	Simulation
com.dccomics.comics	DC Comics	Comics
com.ddi	DoubleDown Casino - FREE Slots	Casino
com.degoo.android.icecreammaker	Ice Cream Maker - cooking game	Casual
com.degoo.android.washpet	Wash Pets - kids games	Casual
com.delta.mobile.android	Fly Delta	Travel & Local
com.demirm.bubble.popping.marine	Bubble Popping For Babies FREE	Family
com.dena.mj	Manga Box: Manga App	Comics
com.dena.west.TransformersBattleTactics	TRANSFORMERS: Battle Tactics	Strategy
com.desjardins.employerd	Employer D	Finance
com.desjardins.mobile	Desjardins mobile services	Finance
com.desmos.calculator	Desmos Graphing Calculator	Education
com.developandroid.android.animals	Animals memory game for kids	Board
com.developandroid.android.girls	Kids memory game: Princess	Board
com.devexpert.weather	Weather & Clock Widget Android	Widgets
com.devhd.feedly	Feedly. Your news reader.	News & Magazines
com.deviantart.android.damobile	DeviantArt	Social
com.devuni.flashlight	Torch - Tiny Flashlight ®	Widgets
com.devuni.flashlight.ledclassic	TF: LED Light Classic	Libraries & Demo
com.devuni.flashlight.screenclassic	TF: Screen Light Classic	Libraries & Demo
com.dg.puzzlebrothers.mahjong.fantasyland	Hidden Mahjong: Fantasy Land	Board
com.dgn.allrecipes	All Recipes	Books & Reference
com.dhqsolutions.enjoyphoto	Photo Effects Pro	Photography
com.dianxinos.dxbs	DU Battery Saver丨Power Doctor	Productivity
com.dianxinos.optimizer.duplay	DU Speed Booster丨Cache Cleaner	Widgets
com.dictionary	Dictionary.com	Books & Reference
com.dic_o.dico_eng_fra	French - English offline dict.	Books & Reference
com.dietcoacher.sos	My Diet Coach - Weight Loss	Health & Fitness
com.digidust.elokence.akinator.freemium	Akinator the Genie FREE	Entertainment
com.digiplex.game	2048	Puzzle
com.digiset.getinstagramfollowers.app	Get Followers for Instagram	Social
com.digitalchemy.calculator.freedecimal	Calculator Plus Free	Tools
com.diogines.pregnancy	Pregnancy calculator	Medical
com.dirtybit.funrun2	Fun Run 2 - Multiplayer Race	Arcade
com.disney.cpcompanion_goo	Club Penguin	Family
com.disney.frozensaga_goo	Frozen Free Fall	Puzzle
com.disney.mdx.wdw.google	My Disney Experience - WDW	Travel & Local
com.disney.nemo	Nemo's Reef	Strategy
com.disney.wheresmymickeyfree_goo	Where's My Mickey? Free	Puzzle
com.disney.wheresmywater2_goo	Where's My Water? 2	Puzzle
com.disney.WMWLite	Where's My Water? Free	Puzzle
com.disney.wordsofwonder_goo	Words of Wonder	Word
com.disneydigitalbooks.PalacePets_goo	Disney Princess Palace Pets	Entertainment
com.distinctivegames.patrickkanefree	Patrick Kane's Arcade Hockey	Sports
com.djinnworks.RNF4	Rope'n'Fly 4	Action
com.djinnworks.StickCliffDiving.lite	Stickman Cliff Diving	Sports
com.djinnworks.StickmanBasketball	Stickman Basketball	Sports
com.djinnworks.StickmanGames.lite	Stickman Games : Summer (Free)	Sports
com.djinnworks.StickmanIceHockey	Stickman Ice Hockey	Sports
com.djinnworks.StickmanSoccer2014	Stickman Soccer 2014	Sports
com.djinnworks.StickmanTennis.free	Stickman Tennis	Sports
com.djit.equalizerplusforandroidfree	Equalizer + mp3 Player Volume	Music & Audio
com.dmap.animatorvideo	Stickfigure Animator Video	Libraries & Demo
com.dmitrievea.LaserBox2	Laser Box - Puzzle	Puzzle
com.dnddream.headsoccer.android	Head Soccer	Sports
com.doctorondemand.android.patient	Doctor On Demand: MD & Therapy	Medical
com.dogbytegames.offroadlegends2	Offroad Legends 2	Racing
com.dogbytegames.offroadlegendsfree	Offroad Legends	Racing
com.domobile.applock	AppLock	Tools
com.doodlejoy.colorbook.zoo	Coloring Book for Kids: Animal	Family
com.doodlejoy.studio.doodleworld	Paint Joy - Color & Draw	Family
com.doodlejoy.studio.kaleidomagic	Magic Paint Kaleidoscope	Family
com.doodlejoy.studio.kaleidoo	Magic Doodle	Casual
com.doodlejoy.studio.kidsdoojoy	Kids Doodle - Color & Draw	Family
com.doubledragonbatii.Acva	Aquarium Live Wallpaper	Personalisation
com.doublelabs.androscreen.echo	Echo Notification Lockscreen	Personalisation
com.doubleTwist.androidPlayer	doubleTwist Music Player	Music & Audio
com.doubleugames.DoubleUCasino	DoubleU Casino - FREE Slots	Casino
com.douglas.upflix	Upflix - Netflix Updates	Entertainment
com.dragonplay.liveholdempro	Live Holdem Poker Pro	Card
com.dragonplay.slotcity	Dragonplay Slots-Slot Machines	Casino
com.drcalculator.android.mortgage	Karl's Mortgage Calculator	Finance
com.dream.collage.maker.pro	Collage Maker Pro	Photography
com.dress14.DoraHairSalon	Dora Hair Salon	Family
com.dressupmedia.android_dress_frozenprincess	Frozen Princess Dress Up	Educational
com.driftwood.galaxybowl.free	Galaxy Bowling 3D HD	Sports
com.drippler.android.updates	Drippler - Android Tips & Apps	News & Magazines
com.droid27.digitalclockweather	Digital clock & world weather	Weather
com.droid27.senseflipclockweather	Sense Flip Clock & Weather	Weather
com.droid27.sensev2flipclockweather	Sense V2 Flip Clock & Weather	Weather
com.droid27.transparentclockweather	Transparent clock & weather	Weather
com.droidhang.ph	Pocket Heroes	Role Playing
com.droidhen.defender2	Defender II	Strategy
com.droidhen.game.poker	DH Texas Poker - Texas Hold'em	Casino
com.dropbox.android	Dropbox	Productivity
com.dropbox.carousel	Carousel - Dropbox Photos	Photography
com.drugscom.app	Drugs.com Medication Guide	Medical
com.drugsdictionary	Very useful drugs dictionary.	Medical
com.dsi.ant.usbservice	ANT USB Service	Libraries & Demo
com.dts.snow.truck.driver	Winter Snow Plow Truck Driver	Simulation
com.dubaipolice.uaedrifting	Dubai Drift	Racing
com.duduapps.craigslistfree	CityShop - App for Craigslist	Shopping
com.dumplingsandwich.pencilsketch	Pencil Sketch	Photography
com.duolingo	Duolingo: Learn Languages Free	Education
com.dynamixsoftware.printershare	PrinterShare™ Mobile Print	Business
com.e8tracks	8tracks playlist radio	Music & Audio
com.ea.BejeweledBlitz_na	Bejeweled Blitz	Puzzle
com.ea.boggle_na	BOGGLE FREE	Puzzle
com.ea.fifaultimate_na	EA SPORTS™ FIFA 15 Companion	Sports
com.ea.game.fifa15_row	FIFA 15 Ultimate Team	Sports
com.ea.game.maddenmobile15_row	Madden NFL Mobile	Sports
com.ea.game.pegglex_row	Peggle Blast	Casual
com.ea.game.pvz2_na	Plants vs. Zombies™ 2	Casual
com.ea.game.pvzfree_row	Plants vs. Zombies FREE	Strategy
com.ea.game.simcitymobile_row	SimCity BuildIt	Simulation
com.ea.game.simpsons4_na	The Simpsons™: Tapped Out	Casual
com.ea.game.tetris2011_na	TETRIS®	Puzzle
com.ea.games.r3_na	Real Racing 3	Racing
com.ea.games.simsfreeplay_na	The Sims™ FreePlay	Simulation
com.ea.gp.bej3	Bejeweled	Casual
com.ea.scrabblefree_na	SCRABBLE	Word
com.ea.tetrisblitz_na	TETRIS® Blitz	Puzzle
com.EAGINsoftware.dejaloYa	Quit smoking - QuitNow!	Health & Fitness
com.eastoakteam.pipiepuzzle_gp	Pipe Puzzle	Board
com.easy.currency.extra.androary	Easy Currency Converter	Finance
com.easygame.marblelegend	Marble Legend	Puzzle
com.ebay.kijiji.ca	Kijiji Free Local Classifieds	Lifestyle
com.ebay.mobile	eBay	Shopping
com.ebooks.ebookreader	Ebook Reader	Books & Reference
com.ecare.menstrualdiary	My Menstrual Diary	Medical
com.ecare.ovulationcalculator	My Ovulation Calculator	Medical
com.eclipsim.gpsstatus2	GPS Status & Toolbox	Travel & Local
com.economist.darwin	The Economist Espresso	News & Magazines
com.eddysoft.comicviewer	Simple Comic Viewer	Comics
com.edjing.edjingdjturntable	edjing - DJ Music Mixer Studio	Music & Audio
com.eekgames.worddrop	Dropwords	Word
com.ef.amvideos	animeMANGA Player for Anime	Comics
com.eggrolldigital.supermodelbeta	Supermodel World Tour	Role Playing
com.eharmony	eHarmony - Online Dating	Social
com.elextech.ram2	Battle Alert 2: 3D Edition	Strategy
com.ember.stainz	Empire Z	Strategy
com.emflag.mahjonglegend	Mahjong Legend	Board
com.emflag.mahjongmaster	Mahjong Master	Puzzle
com.emflag.mahjongoriental	Mahjong Oriental	Board
com.emflag.mahjongsolitaire	Mahjong Solitaire Free	Board
com.emflag.shanghaimahjong	Mahjong Deluxe	Board
com.emoji.coolkeyboard	Emoji Keyboard Pro - Emoticons	Live Wallpaper
com.emoji.Smart.Keyboard	Emoji Smart Android Keyboard	Social
com.emojifamily.emoji.keyboard	Emoji Keyboard for Android L	Personalisation
com.endless.manga	Anime Vostfr - Endless Manga	Comics
com.enflick.android.TextNow	TextNow	Social
com.enginedilema.temperatureconverter	Farenheit to Celsius Converter	Weather
com.enjoycorp.cuteprincesselsawallpaperfrozenworld	Cute Princess Wallpaper:Frozen	Comics
com.enlightment.appslocker	App Lock	Business
com.enrasoft.scratchthat.logoquiz	Scratch That Logo Quiz	Trivia
com.episodeinteractive.android.campuscrush	Campus Crush	Simulation
com.episodeinteractive.android.catalog	Episode - Choose Your Story	Simulation
com.epits.ontariowinterroads	Ontario Winter Road Conditions	Weather
com.epocrates	Epocrates	Medical
com.ericaapps.remote.control	TV Remote Control	Arcade
com.eryodsoft.android.cards.damedepique	Hearts - Free	Card
com.eryodsoft.android.cards.president.lite	President - Card Game - Free	Card
com.escapistgames.starchart	Star Chart	Education
com.espn.score_center	ESPN SportsCenter	Sports
com.estoty.game2048	2048 Number puzzle game	Puzzle
com.estrongs.android.permmgrservice	ES Permission Manager plugin	Libraries & Demo
com.estrongs.android.pop	ES File Explorer File Manager	Productivity
com.estrongs.android.taskmanager	ES Task Manager(Task Killer)	Business
com.estrongs.chromecast	ES Chromecast plugin	Libraries & Demo
com.etermax.apalabrados.lite	Aworded (Apalabrados)	Word
com.etermax.bingocrack.lite	Bingo Crack	Casino
com.etermax.preguntados.lite	Trivia Crack	Trivia
com.etermax.triviafans.fcb.lite	FC Barcelona Trivia Fans	Trivia
com.etermax.triviafans.realmadrid.lite	Real Madrid Trivia Fans	Trivia
com.etermax.wordcrack.lite	Word Crack Free	Word
com.etsy.android	Etsy	Shopping
com.etustudio.android.currency	Currency Exchange Rates	Finance
com.everewoody.guessthedrawing	Guess the Drawing	Trivia
com.everewoody.guessthemovie	Guess the Movie?	Trivia
com.everewoody.guessword	Word Brain Puzzle	Word
com.everimaging.photoeffectstudio	Fotor Photo Editor	Photography
com.evernote	Evernote	Productivity
com.excelatlife.depression	Depression CBT Self-Help Guide	Medical
com.exovoid.weather.app	Weather XL	Live Wallpaper
com.expedia.bookings	Expedia Hotels & Flights	Widgets
com.expensemanager	Expense Manager	Finance
com.explorationbase.ExplorationLite	Exploration Lite	Adventure
com.extreme.car.driving.pro.twonullonefive	Extreme Car Driving PRO 2015	Racing
com.FabulousPixel.TuscanyDive	Tuscany Dive	Libraries & Demo
com.facebook.katana	Facebook	Widgets
com.facebook.orca	Messenger	Communication
com.facebook.pages.app	Facebook Pages Manager	Business
com.facetime_plus.trendy	Facetime Plus Trendy	Business
com.faithcomesbyhearing.android.bibleis	Bible	Books & Reference
com.fake.police.detector	Scare your friends Police joke	Family
com.famousbluemedia.yokee	Karaoke Sing & Record	Music & Audio
com.fanfun.buildasnowmanpianoplay	"Build A Snowman" PianoPlay	Music
com.fanfun.letitgopianoplay	"Let It Go" PianoPlay	Music
com.fanfun.shakeitoffpianoplay	"Shake It Off" PianoPlay	Music
com.farproc.wifi.analyzer	Wifi Analyzer	Tools
com.farproc.wifi.connecter	Wifi Connecter Library	Libraries & Demo
com.fatchicken007.headsupcharades2	Charades!	Word
com.fatsecret.android	Calorie Counter by FatSecret	Health & Fitness
com.fbd.sao	Kirito SAO2 Wallpaper	Comics
com.fcmq.imotoneige	iMotoneige	Sports
com.fdgentertainment.bananakong	Banana Kong	Action
com.fdgentertainment.paperama	Paperama	Puzzle
com.FDGEntertainment.redball4.gp	Red Ball 4	Arcade
com.fedex.ida.android	FedEx Mobile	Business
com.feelingtouch.dipan.slggameglobal	Empire:Rome Rising	Strategy
com.feelingtouch.gnz.realistic	Zombie World War	Arcade
com.feelingtouch.lightshadow.global	Light Shadow Racing Online	Racing
com.fesdroid.logoquiz	Logo Quiz Fun Plus	Word
com.ffgames.sniper	Sniper: Traffic Hunter	Action
com.fgol.HungrySharkEvolution	Hungry Shark Evolution	Arcade
com.fiberlink.maas360.android.docs	MaaS360 Docs	Business
com.fibrum.roallercoastervr	Roller Coaster VR	Adventure
com.fifa.fifaapp.android	FIFA	Sports
com.fiftysixkbit.hockeyhornsfree	Hockey Horns Live	Sports
com.figure1.android	Figure 1 - Medical Images	Medical
com.fiksu.fma.android	FreeMyApps	Entertainment
com.financial.calculator	Financial Calculators	Finance
com.fingersoft.benjibananas	Benji Bananas	Adventure
com.fingersoft.failhard	Fail Hard	Action
com.fingersoft.hillclimb	Hill Climb Racing	Racing
com.firecrackersw.wordbreaker	Word Breaker (Scrabble Cheat)	Word
com.firsttouchgames.dlsa	Dream League Soccer	Sports
com.fitbit.FitbitMobile	Fitbit	Widgets
com.fitnesskeeper.runkeeper.pro	RunKeeper - GPS Track Run Walk	Health & Fitness
com.fitnow.loseit	Lose It!	Health & Fitness
com.fivemobile.cineplex	Cineplex Mobile	Entertainment
com.fivemobile.thescore	theScore: Sports & Scores	Widgets
com.fiverr.fiverr	Fiverr® - Business Services	Business
com.fivestargames.slots	Slots - Big Win Casino	Casino
com.flaregames.rrtournament	Royal Revolt 2: Tower Defense	Action
com.flashgame.prohockey	Pro Hockey	Sports
com.flightaware.android.liveFlightTracker	FlightAware Flight Tracker	Travel & Local
com.flightradar24free	Flightradar24 Free	Travel & Local
com.flightview.flightview_free	FlightView Free Flight Tracker	Travel & Local
com.floern.xkcd	xkcd Browser	Comics
com.flufflydelusions.app.enotesclassiclite	Classic Notes Lite - Notepad	Productivity
com.flyclops.domino.android	Domino!	Board
com.flyersoft.moonreader	Moon+ Reader	Books & Reference
com.flyersoft.plugin_pdf	PDF Plugin - Moon+ Reader Pro	Libraries & Demo
com.flyingmesh.glow	Kids Glow - Doodle with Stars!	Family
com.flyingottersoftware.mega	MEGA	Productivity
com.foba.omegle	Omegle Plus FREE	Social
com.fongo.dellvoice	Fongo - Free Calls +Free Texts	Communication
com.foosegames.pepiskate3d	PEPI Skate 3D	Action
com.forshared	4shared	Entertainment
com.forthblue.pool	Pool Billiards Pro	Sports
com.fourpixels.aircontrol2	Air Control 2	Action
com.foxnews.android	Fox News	News & Magazines
com.foxsports.android	FOX Sports Mobile	Sports
com.fp.cheapoair	CheapOair Flights, Hotel & Car	Travel & Local
com.fpc.triviagame	Pictopia: Disney Edition	Trivia
com.france24.androidapp	FRANCE 24	News & Magazines
com.franconovelli.Respondidos	Trivia Crack Answered	Trivia
com.free.videocalling.live	Video Calling	Social
com.freegamesstudio.copsvsrobbersjailbreak	Cops Vs Robbers: Jail Break	Action
com.freevpnintouch	Unlimited Free VPN - betternet	Tools
com.freshbooks.android	FreshBooks- Invoice+Accounting	Business
com.frogmind.badland	BADLAND	Adventure
com.fromthebenchgames.nbamanager15	NBA General Manager 2015	Sports
com.frostwire.android	FrostWire - File Downloader	Media & Video
com.fsp.android.c	GPS Tracker Pro	Social
com.fsp.android.friendlocator	Find My Friends!	Social
com.fsp.android.phonetracker	Find My Phone!	Entertainment
com.fullersystems.cribbage	Cribbage Pro	Card
com.funbly.guesstext	Guess The Text	Trivia
com.fundoapps.gpsmappaid	GPS Map using Google Maps	Travel & Local
com.funeasylearn.english	Learn English 6000 Words	Education
com.funfactory.photoeditor	Photo Art - Color Effects	Photography
com.fungames.sniper3d	Sniper 3D Assassin: Free Games	Action
com.fungamesforfree.snipershooter.free	Sniper Shooter Free - Fun Game	Action
com.funtomic.Kizi	Kizi - Free Games	Casual
com.fusionmedia.investing	Investing.com Shares & Forex	Finance
com.fusionprojects.edmodo	Edmodo	Education
com.futurebits.instamessage.free	InstaMessage	Social
com.g5e.cursedship.android	The Cursed Ship	Adventure
com.g5e.lettersfromnowherepg.android	Letters From Nowhere: Mystery	Adventure
com.g5e.secretsociety	The Secret Society®	Adventure
com.g5e.specialenquiry	Special Enquiry Detail	Adventure
com.g6677.android.cdentist	Crazy Dentist - Fun games	Arcade
com.g6677.android.eyemakeup	Eyes Makeup Salon - kids games	Educational
com.g6677.android.phairsalon	Hair Salon - Kids Games	Casual
com.g6677.android.pnailspa	Princess Nail Salon	Casual
com.gabrielittner.timetable	Timetable	Education
com.game.basketballshoot	Basketball Shoot	Sports
com.gamehivecorp.kicktheboss2	Beat the Boss 2	Action
com.gamehivecorp.taptitans	Tap Titans	Role Playing
com.gameimax.hairdodesign	Hair Do Design - Girls Game	Family
com.gamelion.cleopatra	Cleopatra Casino - FREE Slots	Casino
com.gamelion.slots	Slots - Journey of Magic	Casino
com.gameloft.android.ANMP.GloftA3HM	Brothers in Arms® 3	Arcade
com.gameloft.android.ANMP.GloftA8HM	Asphalt 8: Airborne	Racing
com.gameloft.android.ANMP.GloftCAHM	Cars: Fast as Lightning	Racing
com.gameloft.android.ANMP.GloftD4HM	Dungeon Hunter 4	Role Playing
com.gameloft.android.ANMP.GloftDMHM	Despicable Me	Casual
com.gameloft.android.ANMP.GloftDOHM	Dragon Mania Legends	Casual
com.gameloft.android.ANMP.GloftF3HM	NFL Pro 2013	Sports
com.gameloft.android.ANMP.GloftGAHM	Gangstar City	Simulation
com.gameloft.android.ANMP.GloftGGHM	Gangstar Vegas	Action
com.gameloft.android.ANMP.GloftHOHM	Heroes of Order & Chaos	Strategy
com.gameloft.android.ANMP.GloftINHM	Blitz Brigade - Online FPS fun	Action
com.gameloft.android.ANMP.GloftIVHM	Ice Age Adventures	Adventure
com.gameloft.android.ANMP.GloftMMHM	Order & Chaos Online	Role Playing
com.gameloft.android.ANMP.GloftNAHM	N.O.V.A. 3: Freedom Edition	Action
com.gameloft.android.ANMP.GloftNJHM	Ninja UP!	Adventure
com.gameloft.android.ANMP.GloftPEHM	Littlest Pet Shop	Family
com.gameloft.android.ANMP.GloftPOHM	MY LITTLE PONY	Casual
com.gameloft.android.ANMP.GloftRAHM	GT Racing 2: The Real Car Exp	Racing
com.gameloft.android.ANMP.GloftSIHM	Spider-Man Unlimited	Action
com.gameloft.android.ANMP.GloftSXHM	Six-Guns: Gang Showdown	Action
com.gameloft.android.ANMP.GloftUOHM	UNO ™ & Friends	Card
com.gameloft.wallpaper.SharkDash	Shark Dash Live Wallpaper	Personalisation
com.gamenauts.ninjafishingfull	Ninja Fishing	Adventure
com.gameresort.penguingame	Adventure Beaks	Adventure
com.gamesforfriends.icomania	Icomania	Word
com.gamesforfriends.matchmania.en	Pic Combo	Word
com.gamesforfriends.trueorfalse	True or False - Test Your Wits	Trivia
com.gamestar.perfectpiano	Perfect Piano	Music
com.gamestar.pianoperfect	Walk Band: Piano,Guitar,Drum..	Music & Audio
com.gamevil.darknessreborn2.android.google.global.normal	Darkness Reborn	Role Playing
com.gamevil.fishing.global	Fishing Superstars : Season3	Sports
com.gamevil.kritikamobile.android.google.global.normal	Kritika: The White Knights	Role Playing
com.gamevil.monster.global	Monster Warlord	Adventure
com.ganoteria.WazeTalkAndDrive	Talk And Drive App For Waze	Travel & Local
com.garciahierro.ragecomics	Rage Comics	Comics
com.garmin.android.apps.connectmobile	Garmin Connect™ Mobile	Health & Fitness
com.gasparrigames.tapthemusic	Tap the music	Music
com.gau.go.launcherex	GO Launcher EX-free theme,fast	Personalisation
com.gau.go.launcherex.gowidget.weatherwidget	GO Weather Forecast & Widgets	Live Wallpaper
com.geaxgame.gamezone.texas	Texas Holdem Poker	Card
com.genia.sequence	Which Comes First?	Trivia
com.genina.android.blackjack.view	BlackJack 21 FREE	Casino
com.getsomeheadspace.android	Headspace.com - meditation	Health & Fitness
com.gexperts.ontrack	OnTrack Diabetes	Medical
com.gismart.guitar	Real Guitar Free	Music & Audio
com.github.jamesgay.fitnotes	FitNotes - Gym Workout Log	Health & Fitness
com.glassdoor.app	Job Search, Salaries & Reviews	Business
com.globalegrow.app.sammydress	SammyDress - Dress for Less	Shopping
com.globaltv.android.weather	Global News Skytracker	Weather
com.glossarium.ninjaturtle	Turtle Ninja Jump	Adventure
com.glu.contractkiller3	CONTRACT KILLER: SNIPER	Action
com.glu.deerhunt2	DEER HUNTER 2014	Action
com.glu.dino	DINO HUNTER: DEADLY SHORES	Action
com.glu.stardomkim	KIM KARDASHIAN: HOLLYWOOD	Adventure
com.glu.stardomng	STARDOM: HOLLYWOOD	Adventure
com.gmail.heagoo.hackerdemo	Real Hacker Demo	Libraries & Demo
com.gn.android.compass	Compass	Tools
com.godynamo.zweet.app	Zweet	Shopping
com.gogii.textplus	textPlus Free Text + Calls	Social
com.gold_stone_studio.candyheroesstory8043	Candy Heroes Story	Board
com.golfzonent.spingolf	Golf King	Sports
com.goodreads	Goodreads	Books & Reference
com.google.android.apps.adm	Android Device Manager	Tools
com.google.android.apps.chromecast.app	Chromecast	Tools
com.google.android.apps.docs.editors.docs	Google Docs	Productivity
com.google.android.apps.docs.editors.sheets	Google Sheets	Productivity
com.google.android.apps.docs.editors.slides	Google Slides	Productivity
com.google.android.apps.finance	Google Finance	Finance
com.google.android.apps.fitness	Google Fit	Health & Fitness
com.google.android.apps.genie.geniewidget	Google News & Weather	News & Magazines
com.google.android.apps.hangoutsdialer	Hangouts Dialer - Call Phones	Communication
com.google.android.apps.inbox	Inbox by Gmail	Productivity
com.google.android.apps.messaging	Messenger	Communication
com.google.android.apps.paidtasks	Google Opinion Rewards	Tools
com.google.android.apps.translate	Google Translate	Tools
com.google.android.apps.unveil	Google Goggles	Productivity
com.google.android.apps.vega	Google My Business	Business
com.google.android.apps.youtube.creator	YouTube Creator Studio	Media & Video
com.google.android.keep	Google Keep - notes and lists	Productivity
com.google.android.launcher	Google Now Launcher	Tools
com.google.android.maps.mytracks	My Tracks	Health & Fitness
com.google.android.stardroid	Sky Map	Books & Reference
com.google.android.wearable.app	Android Wear	Communication
com.google.chromeremotedesktop	Chrome Remote Desktop	Tools
com.google.earth	Google Earth	Travel & Local
com.google.samples.apps.cardboarddemo	Cardboard	Libraries & Demo
com.google.zxing.client.android	Barcode Scanner	Shopping
com.gopro.smarty	GoPro App	Photography
com.goseet.VidTrim	VidTrim - Video Editor	Media & Video
com.gotv.crackle.handset	Crackle - Movies & TV	Entertainment
com.gotv.nflgamecenter.us.lite	NFL Mobile	Sports
com.gramgames.tenten	1010! Puzzle	Puzzle
com.graphilos.epub	ePub Reader for Android	Books & Reference
com.greatplayer.hairstylesgirls	Game Girls Hairstyles	Puzzle
com.gree.bfherorun	Batman & The Flash: Hero Run	Action
com.greenshield.mobileclaims	GSC on the Go	Finance
com.grillgames.guitarrockhero	Rock Hero	Music
com.groupme.android	GroupMe	Communication
com.groupon	Groupon	Shopping
com.gsn.android.casino	GSN Casino	Casino
com.gsn.android.tripeaks	Solitaire TriPeaks	Card
com.gsn.grandcasino	GSN Grand Casino	Casino
com.guardian	The Guardian	News & Magazines
com.guillaumegranger.mc	Menstrual Calendar	Medical
com.gunmodstwo.qwe	Weapon Mods	Books & Reference
com.gxbwfw.offroadfree	4×4 Mountain Offroad 3D	Adventure
com.gzone.android.livestreamapp	Sport Live Stream	Sports
com.haaz.dartsscoreboard	Darts Scoreboard	Sports
com.halfbrick.fruitninjafree	Fruit Ninja Free	Arcade
com.halfbrick.jetpackjoyride	Jetpack Joyride	Arcade
com.halfbrick.monsterdash	Monster Dash	Arcade
com.hamsterbeat.wallpapers.fx.color.free	Weather Now Forecast & Widgets	Weather
com.handmark.expressweather	1Weather:Widget Forecast Radar	Weather
com.handmark.sportcaster	CBS Sports	Sports
com.handyapps.expenseiq	Expense IQ - Expense Manager	Finance
com.handyapps.photoLocker	Hide Pictures in Photo Locker	Media & Video
com.handyapps.tipnsplit	Tip N Split Tip Calculator	Finance
com.hanna.beautiful	Beautiful Wallpapers	Personalisation
com.haptic.chesstime	Chess Time™ -Multiplayer Chess	Board
com.hasbro.FurbyBoom	Furby BOOM!	Family
com.hasbro.tf360appstore	Transformers: RobotsInDisguise	Adventure
com.havos.g.compactcrossword	Compact Crossword	Word
com.hcg.cok.gp	Clash of Kings	Strategy
com.hcom.android	Hotels.com – Hotel Booking	Travel & Local
com.headcode.ourgroceries	Our Groceries Shopping List	Shopping
com.headgraphix.bruh	Bruh Button	Arcade
com.headupgames.bridgeconstructorfreeversion	Bridge Constructor FREE	Simulation
com.hedgehogacademy.logicspatialintelligencelite	Logic for kids 3 7 years Free	Educational
com.helpsgood.candidate	candiDate - Free Dating App	Lifestyle
com.here.app.maps	HERE Beta: Offline maps & nav	Travel & Local
com.herman.ringtone	Ringtone Maker	Media & Video
com.herocraft.game.free.icerage	Ice Rage: Hockey Free	Sports
com.hexadev.newkeypad.lock.screen	Keypad Lock Screen	Personalisation
com.HGames.RGHero	Rock vs Guitar Legends 2015	Music
com.hideitpro	Hide Pictures - Hide it Pro	Media & Video
com.highbrow.games.TOF	Team of Fantasy	Role Playing
com.hmobile.biblekjv	King James Bible FREE	Books & Reference
com.HomeNetGames.ZombieDefense	Zombie Defense	Strategy
com.hoopladigital.android	Hoopla Digital	Books & Reference
com.hoteltonight.android.prod	Hotel Tonight	Travel & Local
com.hotheadgames.google.free.bigleaguehockey	Big Win NHL Hockey	Sports
com.hotheadgames.google.free.bigwinbasketball	BIG WIN Basketball	Sports
com.hotheadgames.google.free.bigwinhockey	BIG WIN Hockey	Sports
com.hotheadgames.google.free.rawsniper	Kill Shot	Simulation
com.hotornot.app	Hot or Not	Lifestyle
com.hotwire.hotels	Hotwire Hotels & Cars	Travel & Local
com.houzz.app	Houzz Interior Design Ideas	Lifestyle
com.howtostudios.learntodrawanimemanga	Learn to Draw Anime Manga	Comics
com.hp.android.print	HP ePrint	Photography
com.hp.pregnancy.lite	Pregnancy +	Medical
com.hp.printercontrol	HP All-in-One Printer Remote	Productivity
com.hpgame.MiniomsMusicPlay	Minion Music	Music
com.hrfy.plus	Home Remedies	Medical
com.hs3lzx.coloringprincess	Princess coloring kids paint	Educational
com.hsag.mahjongsolitaire	Mahjong Solitaire Free	Puzzle
com.hssn.anatomyfree	Visual Anatomy Free	Medical
com.huffingtonpost.android	Huffington Post	News & Magazines
com.hugsnhearts.android_frozen_beauty_queen	Frozen Beauty Queen	Family
com.hugsnhearts.android_fun_fair_food	Fair Food Maker - Carnival Fun	Educational
com.hugsnhearts.android_mynewbaby	New Baby and Me!	Educational
com.hugsnhearts.android_petvet	Pet Vet Doctor - puppy & kitty	Family
com.hutchgames.mud	MMX Racing	Racing
com.huuuge.vegas	Las Vegas Casino - Free Slots	Casino
com.huuuge.zeus	Zeus Casino - FREE Slots	Casino
com.hyperkani.bomberfriends	Bomber Friends	Action
com.Hypnosis	Free Hypnosis	Medical
com.hz.game.cd	Castle Defense	Strategy
com.i6.FlightSimulatorAirplane3D	Flight Simulator: Fly Plane 3D	Simulation
com.i6.PoliceFastCarDriving3D	Fast Police Car Driving 3D	Racing
com.iabuzz.puzzle4kidsAnimals	Animals Puzzle for Kids	Puzzle
com.ianhanniballake.contractiontimer	Contraction Timer	Medical
com.iberoamericangames.encabeza	@head!	Word
com.ibm.events.android.ausopen	Australian Open Tennis 2015	Sports
com.ibm.timhortons.android	TimmyMe	Lifestyle
com.icecoldapps.screenshoteasy	Screenshot Easy	Tools
com.icenta.sudoku.ui	Sudoku Free	Puzzle
com.icestone.Emoji	Emoji keyboard for Android	Tools
com.ichi2.anki	AnkiDroid Flashcards	Education
com.iconology.comics	Comics	Comics
com.icsnetcheckin.gamma	Net Check In - Gamma-Dynacare	Medical
com.ideashower.readitlater.pro	Pocket	News & Magazines
com.ifttt.ifttt	IFTTT	Productivity
com.igames.appleshooter3d	Apple Shooter 3D - 2	Casual
com.igg.android.bloodblade	Blood & Blade	Role Playing
com.igg.android.clashofgangs_en	Clash of Gangs	Strategy
com.igg.android.clashofmafias	Clash of Mafias	Strategy
com.igg.android.galaxyonline3_beta	Galaxy Online 3	Strategy
com.igg.android.godsrush_en	Gods Rush	Strategy
com.igg.android.im	LINK - with people nearby	Communication
com.igg.bravetrials	Brave Trials	Role Playing
com.igg.bzbee.bingobyigg	Bingo by IGG: Top Bingo+Slots!	Casino
com.igg.bzbee.deckheroes	Deck Heroes	Card
com.igg.bzbee.slotsdeluxe	Slot Machines by IGG	Casino
com.igg.castleclash	Castle Clash	Strategy
com.igg.castleclash_fr	Clash de Châteaux:Castle Clash	Strategy
com.igg.clashoflords2	Clash of Lords 2	Strategy
com.igg.pokerdeluxe	Texas HoldEm Poker Deluxe	Casino
com.igs.slotsparadise	Slots Paradise™	Casino
com.ijinshan.kbackup	CM Backup -Restore,Cloud,Photo	Productivity
com.ijinshan.kbatterydoctor_en	Battery Doctor(Battery Saver)	Widgets
com.ikea.app	IKEA	Lifestyle
com.ikea.catalogue.android	IKEA Catalogue	Lifestyle
com.ikeyboard.theme.petal	Petal Emoji Keyboard Theme	Personalisation
com.ikeyboard.theme.Rainyday	RainyDay for Emoji Keyboard	Weather
com.ilike.cartoon	漫画人：为爱漫画的人而生	Comics
com.imagemetrics.lorealparisandroid	Makeup Genius	Lifestyle
com.ImaginationUnlimited.instaframe	Photo Editor&Instagram Collage	Photography
com.imangi.templerun	Temple Run	Arcade
com.imangi.templerun2	Temple Run 2	Action
com.imdb.mobile	IMDb Movies & TV	Entertainment
com.immortalrobot.publicevents	Destiny Public Event Timer	Books & Reference
com.imo.android.imoim	imo free video calls and chat	Communication
com.impossible.geometry.test	Dodo: Impossible Geometry Test	Adventure
com.indeed.android.jobsearch	Job Search	Business
com.INeedPlay.Fivenight	Five Nights At Buddy	Strategy
com.infiapps.chineseslots	Chinese Slots	Casino
com.infiapps.slotbonanza	Slot Bonanza-FREE Casino Slots	Casino
com.infiapps.tikislots	Tiki Slots	Casino
com.infraware.office.link	Polaris Office + PDF	Business
com.innerjoygames.guitarlegend	Guitar Legend	Music
com.inspiredart.niceweather	Cute Weather	Weather
com.inspiredart.swiperweatherwidget	Cute Weather Widget	Weather
com.instagram.android	Instagram	Social
com.instantbits.cast.webvideo	Web Video Caster (Chromecast)	Media & Video
com.intellijoy.abc.trains.lite	Games for Kids	Educational
com.intellijoy.android.reading.free	Games for Kids Under 6 Years	Educational
com.intellijoy.android.shapes	Kids Games Shapes for Toddlers	Educational
com.intentsoftware.crazyeights.lite	CrazyEights	Card
com.interactive8.readmestories	Read Me Stories: Kids' Books	Education
com.intsig.BCRLite	CamCard Free - Business Card R	Business
com.intsig.camscanner	CamScanner -Phone PDF Creator	Productivity
com.intuit.quickbooks	QuickBooks Online	Business
com.investorvista.stockspyod	Stocks: Realtime Quotes Charts	Finance
com.invoice2go.invoice2goplus	Invoice2go - Invoice App	Business
com.iphodroid.deltaplanne	Hang Gliding	Libraries & Demo
com.isawan.mkfacetimecallg	Make a Face Time Call	Communication
com.isrtransit.stm	STM	Transport
com.issuu.android.app	Issuu: A world of magazines	News & Magazines
com.itbenefit.android.calendar	Calendar Widget: Month+Agenda	Productivity
com.itunestoppodcastplayer.app	Podcast Republic	News & Magazines
com.iudesk.android.photo.editor	Photo Editor	Photography
com.iugome.lilknights	Knights & Dragons	Action
com.iversecomics.archie.android	Archie Comics	Comics
com.ivona.tts	IVONA Text-to-Speech HQ	Libraries & Demo
com.ivygames.morskoiboi	Sea Battle	Board
com.iwaredesigns.prodarts	Pro Darts 2014	Sports
com.iwaredesigns.propool2012	Pro Pool 2015	Sports
com.iwin.dond	Deal or No Deal	Casino
com.ixl.ixlmath	IXL Maths Practice	Education
com.jackthreads.android	JackThreads: Shopping for Guys	Shopping
com.jaekkl.forest	Forest	Adventure
com.jandusoft.gtc	Guess The Character	Board
com.jangomobile.android	Jango Radio	Music & Audio
com.jarbull.wims	Hidden Object Adventure *Free*	Adventure
com.jaumo	Flirt, Chat & Dating ♥ JAUMO	Social
com.jb.gokeyboard.theme.glass.getjar	Free Glass GO Keyboard Theme	Personalisation
com.jb.gosms	GO SMS Pro	Communication
com.JDM4iK.GYMKHANADRIFT	GYMKHANA DRIFT	Racing
com.jeffreys.euchre	Euchre (free)	Card
com.jellyvisiongames.YOUDONTKNOWJACK	YOU DON'T KNOW JACK	Trivia
com.jessdev.hdcameras	HD Camera Ultra	Photography
com.jg.snake.simulator	Snake Attack 3D Simulator	Simulation
com.jg.spongeminds.preschooldemo	Preschool All-In-One	Educational
com.jiubang.goscreenlock	GO Locker - theme & wallpaper	Personalisation
com.jiwire.android.finder	WiFi Finder	Travel & Local
com.jk.dailytext	Daily Text 2015	Books & Reference
com.joelapenna.foursquared	Foursquare	Travel & Local
com.joeware.android.gpulumera	Candy Camera – Selfie Selfies	Photography
com.joeware.android.gpulumera.res.sticker	Candy Camera - Sticker	Libraries & Demo
com.joeykrim.rootcheck	Root Checker	Tools
com.joshclemm.android.quake	Earthquake Alert!	News & Magazines
com.jrtstudio.AnotherMusicPlayer	Music Player : Rocket Player	Music & Audio
com.jrtstudio.music	Music Player for Android	Widgets
com.jsdev.instasize	InstaSize	Photography
com.julian.fastracing	Fast Racing 3D	Racing
com.julian.motorboat	Powerboat Racing 3D	Racing
com.jumpgames.rswrb	Real Steel World Robot Boxing	Action
com.june.guessthemovie	Guess The Movie ®	Trivia
com.june.think	Think	Trivia
com.jungle.dario.run.world	Gino´s World	Adventure
com.justeat.app.ca	JUST EAT - Takeout Online	Lifestyle
com.jv.materialfalcon	Falcon Pro 3	Social
com.kabam.cnthg	The Hunger Games: Panem Rising	Role Playing
com.kabam.ff6android	Fast & Furious 6: The Game	Action
com.kabam.fortress	The Hobbit: Kingdoms	Strategy
com.kabam.marvelbattle	Marvel Contest of Champions	Action
com.kakao.talk	KakaoTalk: Free Calls & Text	Communication
com.kapustin.app.realflowersfree	Kids Touch Games free	Educational
com.karmangames.canasta	Canasta	Card
com.karmangames.euchre	Euchre	Card
com.karmangames.hearts	Hearts	Card
com.kathleenOswald.pyramidGooglePlay	Pyramid Solitaire	Card
com.kathleenOswald.solitaireGooglePlay	Solitaire	Card
com.kayak.android	KAYAK Flights, Hotels & Cars	Travel & Local
com.kb.Carrom3D	Pool Break 3D Billiard Snooker	Sports
com.kedoo.talkingbooba	Talking Booba: Santa’s Pet	Entertainment
com.kep.driving.canadian	Canadian Driving Tests	Education
com.keramidas.MarketUpdateHelper	Market Update Helper	Libraries & Demo
com.kestrel.BBVP	Beat Beat Vocaloid Plus	Music
com.ketchapp.amazingthief	Amazing Thief	Adventure
com.ketchapp.circle	Circle	Arcade
com.ketchapp.circlethedot	Circle The Dot	Arcade
com.ketchapp.donttouchthespikes	Don't Touch The Spikes	Arcade
com.ketchapp.jump	Jump	Arcade
com.ketchapp.jumpcar	Jump Car	Action
com.ketchapp.ninja	Amazing Ninja	Action
com.ketchapp.phases	Phases	Arcade
com.ketchapp.stickhero	Stick Hero	Arcade
com.ketchapp.twocars	2 Cars	Adventure
com.kevinbradford.games.barnyardgamesfree	Barnyard Games For Kids Free	Educational
com.kevinbradford.games.firstgrade	First Grade Learning Games	Educational
com.kevinbradford.games.preschoolgames	Preschool and Kindergarten	Educational
com.kids.cartoon.quiz	Cartoon Quiz	Trivia
com.kidsfoodinc.android_make_icecream	Frozen Ice Cream Maker	Family
com.kidsfoodinc.android_make_icepopssalonkf	Frozen Pops Maker - Cool Food!	Family
com.kidsfoodinc.android_make_slushy	Frozen Slushy Maker	Family
com.kidsfoodinc.android_make_snowcones	Frozen Snow Cone Maker	Educational
com.kii.safe	Hide pictures - KeepSafe Vault	Media & Video
com.killab.SkycraftDeluxe	Skycraft 3D - Butter Gun	Adventure
com.kiloo.subwaysurf	Subway Surfers	Arcade
com.kindara.pgap	Kindara Fertility Tracker	Medical
com.kineticcafe.kfccolonelsclub	KFC Canada Colonel's Club	Shopping
com.king.candycrushsaga	Candy Crush Saga	Casual
com.king.candycrushsodasaga	Candy Crush Soda Saga	Casual
com.king.farmheroessaga	Farm Heroes Saga	Casual
com.king.petrescuesaga	Pet Rescue Saga	Casual
com.king.pyramidsolitairesaga	Pyramid Solitaire Saga	Card
com.kiragames.unblockmefree	Unblock Me FREE	Puzzle
com.kitkatandroid.moviemaker	Movie Maker - Video Editor	Media & Video
com.kittyplay.ex	Kitty Play - Theme & Iconpack	Personalisation
com.kiwi.westbound	Westbound: Pioneer Adventure	Simulation
com.kiwifruitmobile.sudoku	Super Sudoku	Board
com.kkkeyboard.emoji.keyboard.theme.RainbowLove	Rainbow Love Emoji Keyboard	Personalisation
com.km.cutpaste.util	Cut Paste Photos	Photography
com.KnowledgeAdventure.SchoolOfDragons	School of Dragons	Role Playing
com.kobobooks.android	Kobo Books	Books & Reference
com.kodak.wmc.rsscombinedapp	Walmart Photo	Photography
com.komik.free	Komik Reader - Free	Comics
com.konami.ygodgtest	Yu-Gi-Oh! Duel Generation	Card
com.kongregate.mobile.epicskater.google	Epic Skater	Arcade
com.kongregate.mobile.gameofthronesascent.google	Game of Thrones Ascent	Role Playing
com.kongregate.mobile.lionhearttactics.google	Lionheart Tactics	Role Playing
com.kongregate.mobile.run.google	Run	Arcade
com.koo.lightmanager	Light Manager - LED Settings	Productivity
com.koodo.selfserve	Koodo Self Serve	Productivity
com.korakot.wordooj.MSWORDREFERENCEVII	M-S Word 2007 Quick Reference	Education
com.koushikdutta.cast	AllCast	Media & Video
com.krazymobile.emojismartkeyboard	Emoji Smart Keyboard	Social
com.kreactive.leparisienrssplayer	Le Parisien	News & Magazines
com.kristanix.android.jigsawpuzzleepic	Jigsaw Puzzles Epic	Puzzle
com.kristanix.android.mahjongsolitaireepic	Mahjong Solitaire Epic	Board
com.kristanix.android.sudokuepic2	Sudoku Epic	Board
com.krivoz.submangareader	Manga - MangaSeed	Comics
com.ksmobile.cb	CM Browser - Fast & Secure	Communication
com.ksmobile.launcher	CM Launcher - Boost, Secure	Personalisation
com.kvadgroup.photostudio	Photo Studio	Photography
com.kvandroid.logoquiz	Logo Quiz 2015	Trivia
com.landoncope.games.toddlersingandplay	Toddler Sing and Play	Music
com.latestringtonescool	Latest Ringtones	Music & Audio
com.laurencedawson.reddit_sync	reddit sync	News & Magazines
com.ldf.grossesse.view	Ma grossesse	Medical
com.ldf.ovulation.view	Ovulation	Medical
com.ldw.virtualfamilies2	Virtual Families 2	Casual
com.leaguestat.lsmobileappohl	OHL	Sports
com.learninga_z.onyourown	Raz-Kids	Education
com.leconjugueur.droid	Le Conjugueur	Books & Reference
com.leftover.CoinDozer	Coin Dozer	Casino
com.lego.bionicle.maskofcreation	LEGO® BIONICLE®	Action
com.lego.bricksmore	LEGO® Juniors Create & Cruise	Educational
com.lego.city.my_city	LEGO® City My City	Action
com.lego.creator.creatorislands	LEGO® Creator Islands	Strategy
com.lego.duplo.icecream	LEGO® DUPLO® Ice Cream	Educational
com.lego.duplo.trains	LEGO® DUPLO® Train	Puzzle
com.lego.juniors.quest	LEGO® Juniors Quest	Adventure
com.lego.ninjago.rebooted	LEGO® Ninjago REBOOTED	Action
com.lego.starwars.thenewyodachronicles	LEGO® Star Wars™ Yoda II	Action
com.lego.starwars.theyodachronicles	LEGO® STAR WARS™	Arcade
com.lego.technic.race	LEGO® Technic Race	Racing
com.lemonde.androidapp	Le Monde, l'info en continu	News & Magazines
com.levelind.linken	Linken	Puzzle
com.lexi.android	Lexicomp	Medical
com.lezhi.WeddingSpaSalon	Wedding Spa Salon-Girls Games	Family
com.lge.tv.remoteapps	LG TV Remote	Entertainment
com.libiitech.jungledoctor	Jungle Doctor	Family
com.libiitech.makeup	Make-Up Me	Family
com.libiitech.monsterhairsalon	Monster Hair Salon	Family
com.libiitech.nailsalon	Nail Salon	Family
com.libiitech.princesssalon	Princess Salon	Family
com.life360.android.safetymapd	Family Locator	Lifestyle
com.liferecipes.healthyrecipes	Healthy Recipes	Libraries & Demo
com.linecorp.LGTMTMG	LINE: Disney Tsum Tsum	Puzzle
com.linkedin.android	LinkedIn	Widgets
com.listia.Listia	Get Free Stuff on Listia	Shopping
com.livescore	LiveScore	Sports
com.livestream.livestream	Livestream	Media & Video
com.livingsocial.www	LivingSocial	Shopping
com.liwenwen20131497.star	Star flying live wallpaper	Libraries & Demo
com.lixar.allegiant	Allegiant2Go	Travel & Local
com.llapps.mirrorphoto	Mirror Photo:Editor&Collage	Photography
com.lochmann.fourinarow	4 in a Row	Board
com.lockwoodpublishing.avakinlife	Avakin Life	Role Playing
com.lonelyfew.blendoku	Blendoku	Puzzle
com.lotus.sync.traveler	IBM Notes Traveler	Business
com.loudcrow.marvelavengers	The Avengers-Iron Man Mark VII	Comics
com.lovedetector.jherenu	Love  ♥ Love ♥	Libraries & Demo
com.lslk.sleepbot	SleepBot - Sleep Cycle Alarm	Health & Fitness
com.lucasarts.starts_goo	Star Wars: Commander	Strategy
com.lucentvisions.wallpapers.NorthernLightsFree	Northern Lights FREE (Aurora)	Personalisation
com.luckycoin.currencyconverter	Simple Currency Converter	Finance
com.luckyfish.omgfortune	OMG! Fortune FREE Slots	Casino
com.luckystargame.nightmare2048.en	2048 ★ Nightmare	Trivia
com.luckyxmobile.babycare	Baby Care - track baby growth!	Medical
com.ludia.dragons	Dragons: Rise of Berk	Simulation
com.ludia.familyfeudandfriends.free	Family Feud® & Friends	Trivia
com.ludia.familyfeudblitz	Family Feud® 2	Trivia
com.ludia.FifthGrader.free	5th Grader?® & Friends	Trivia
com.ludia.jurassicpark	Jurassic Park™ Builder	Simulation
com.ludia.millionairefree	Who Wants To Be A Millionaire	Trivia
com.ludia.peabodyfree	Mr. Peabody & Sherman	Trivia
com.ludia.tpirslots	The Price is Right™ Slots	Casino
com.lulo.scrabble.classicwords	Classic Words Solo	Word
com.lumoslabs.lumosity	Lumosity	Education
com.luxury.car.simulator	Luxury Car Simulator	Simulation
com.lyrebirdstudio.colorizer.lite	Colour Effect Photo Editor	Photography
com.lyrebirdstudio.mirror	Mirror Image - Photo Editor	Photography
com.machinezone.gow	Game of War - Fire Age	Strategy
com.macropinch.hydra.android	Cardiograph	Health & Fitness
com.macropinch.swan	Weather	Weather
com.madefire.reader	Madefire Comics & Motion Books	Comics
com.madfingergames.deadtrigger2	DEAD TRIGGER 2	Action
com.madfingergames.monzo	MONZO	Entertainment
com.magicjack	magicApp: Free Calls	Social
com.magisto	Magisto Video Editor & Maker	Photography
com.magix.android.mmjam	Music Maker Jam	Music & Audio
com.magmamobile.game.Checkers2	Checkers 2	Board
com.magmamobile.game.SolitaireCollection	Solitaire Collection	Card
com.magmamobile.game.SpiderSolitaire	Spider Solitaire	Card
com.magmic.phase10.lite	Phase 10 Free	Card
com.mailboxapp	Mailbox	Productivity
com.MaMouer.lockscreen	Lock Screen & Live Wallpaper	Libraries & Demo
com.mandongkeji.comiclover	追追漫画	Comics
com.mangaphoenix.app	Manga Phoenix	Comics
com.mapfactor.navigator	MapFactor: GPS Navigation	Travel & Local
com.mapquest.android.ace	MapQuest GPS Navigation & Maps	Travel & Local
com.mapswithme.maps.pro	MAPS.ME –Offline Map & Routing	Travel & Local
com.martinvillar.android.bibliaenfrances	Bible en français Louis Segond	Books & Reference
com.marvel.comics	Marvel Comics	Comics
com.marvel.unlimited	Marvel Unlimited	Comics
com.marvelousgames.touchracing2	Touch Racing 2	Racing
com.marycastro940.ClassicBoardGames	Classic Board Games	Shopping
com.mastercomlimited.racethetrafficmoto	Race the Traffic Moto	Racing
com.Mata.YTplayer	Viral Popup (Youtube Player)	Media & Video
com.match.android.matchmobile	Match™ Dating - Meet Singles	Social
com.mate1.DatingApp	Mate1.com - Date Local Singles	Social
com.MathUnderground.MathSolver	yHomework - Math Solver	Education
com.mationmedia.skateboardgame	Skateboard Free	Sports
com.mattdonders.android.wppcalculator	WWPP Calculator & Tracker	Health & Fitness
com.mattia.videos.manager	Playlist Viewer for YouTube	Entertainment
com.mavenhut.solitaire	Solitaire Arena	Card
com.mavenhut.solitaire3	Solitaire 3 Arena	Card
com.max.Anatomy	Human Anatomy	Medical
com.maxgames.ageofwar1	Age of War	Strategy
com.maxmpz.audioplayer	Poweramp Music Player (Trial)	Music & Audio
com.mb.android	Media Browser for Android	Media & Video
com.mcdonalds.superapp	McDonald's Canada	Lifestyle
com.media.moviestudio	Video Maker Movie Editor	Media & Video
com.mediagrif.lespac.app	LesPAC Petites annonces Québec	Lifestyle
com.medicalgroupsoft.medical.directorymedtermsmultilang.free	Medical Terminologies (Free)	Medical
com.mediocre.smashhit	Smash Hit	Arcade
com.medscape.android	Medscape	Medical
com.meetup	Meetup – Make community real	Social
com.mejdeutchapps.sporttv	Sport TV	Sports
com.melodis.midomiMusicIdentifier.freemium	SoundHound	Music & Audio
com.merriamwebster	Dictionary - Merriam-Webster	Books & Reference
com.metago.astro	ASTRO File Manager with Cloud	Productivity
com.mfar.flyerify	Flyerify: Flyers Canada	Shopping
com.mgstudio.bg	Battle Glory	Strategy
com.mh.guitarheroes	Guitar Heroes:Be a Guitar Hero	Music
com.mhriley.spendingtracker	Spending Tracker	Finance
com.miantan.myoface	FaceQ	Entertainment
com.michaels.michaelsstores	Michaels Stores	Lifestyle
com.microgames.deadninja	Dead Ninja Mortal Shadow	Adventure
com.microphone.earspy	Ear Spy: Super Hearing	Medical
com.microsoft.amp.apps.bingfinance	MSN Money – Stock Quotes	Finance
com.microsoft.amp.apps.bingnews	MSN News – Breaking Headlines	News & Magazines
com.microsoft.amp.apps.bingweather	MSN Weather	Weather
com.microsoft.exchange.mowa	OWA for Android (Pre-Release)	Communication
com.microsoft.msa.authenticator	Microsoft account	Productivity
com.microsoft.office.excel	Microsoft Excel Preview	Productivity
com.microsoft.office.lync15	Lync 2013	Business
com.microsoft.office.officehub	Microsoft Office Mobile	Productivity
com.microsoft.office.onenote	OneNote	Productivity
com.microsoft.office.powerpoint	Microsoft PowerPoint Preview	Productivity
com.microsoft.office.word	Microsoft Word Preview	Productivity
com.microsoft.rdc.android	Microsoft Remote Desktop	Business
com.microsoft.skydrive	OneDrive	Productivity
com.microsoft.smartglass	Xbox 360 SmartGlass	Entertainment
com.microsoft.xboxone.smartglass	Xbox One SmartGlass	Entertainment
com.midasplayer.apps.bubblewitchsaga2	Bubble Witch 2 Saga	Casual
com.midasplayer.apps.diamonddiggersaga	Diamond Digger Saga	Casual
com.midasplayer.apps.papapearsaga	Papa Pear Saga	Casual
com.mikeperrow.spiral	Hypnotic Spiral	Libraries & Demo
com.mindblocks.blocks_light	Block Story	Role Playing
com.mindbodyonline.connect	MINDBODY Connect	Health & Fitness
com.mindcandy.warriors	World of Warriors	Role Playing
com.mindifi.deepsleephypnosis	Deep Sleep and Relax Hypnosis	Medical
com.miniclip.eightballpool	8 Ball Pool	Sports
com.miniclip.istunt2	iStunt 2	Sports
com.miniclip.plagueinc	Plague Inc.	Simulation
com.miniclip.soccerstars	Soccer Stars	Sports
com.minomonsters.client	Mino Monsters World	Adventure
com.mint	Mint.com Personal Finance	Finance
com.mirego.cogeco	Cogeco Radio	Music & Audio
com.misfitwearables.prometheus	Misfit	Health & Fitness
com.mistwalkercorp.guardians	Terra Battle	Role Playing
com.miteksystems.android.mobiledeposit.brandable.rbcgeorgia	RBC Bank U.S. Remote Deposit	Finance
com.mm.security.androidhider1	Application Hider	Libraries & Demo
com.mn2square.slowmotionplayer	Video Slow Motion Player	Media & Video
com.mobage.ww.a1439.Bingo_PartyLand_Android	Bingo PartyLand	Casino
com.mobage.ww.a1879.Cupcake_Carnival_Android	Cupcake Carnival	Puzzle
com.mobage.ww.a1903.SWTD_Android	Star Wars ™: Galactic Defense	Strategy
com.mobage.ww.a1912.Godus_Android	Godus	Simulation
com.mobage.ww.a5225.tf2_Android	TRANSFORMERS AGE OF EXTINCTION	Action
com.mobeam.beepngo	Beep'nGo - Wallet & Coupons	Shopping
com.mobi.manga.reader	Mobi Manga	Comics
com.mobile.shnarped	Shnarped Hockey	Sports
com.mobilemotion.dubsmash	Dubsmash	Media & Video
com.mobilesrepublic.appy	News Republic – Smarter news	News & Magazines
com.mobilityware.freecell	FreeCell Solitaire	Card
com.mobilityware.solitaire	Solitaire	Card
com.mobilityware.spider	Spider Solitaire	Card
com.mobiloids.kidsmath	Kids Math	Educational
com.mobincube.android.sc_9Y7S3	Marijuana Strain Guide	Medical
com.mobinlife.picsquiz	PICS QUIZ - Guess the words!	Trivia
com.mobirix.brick	Bricks Breaker King	Arcade
com.mobirix.dragonseal	Dragon Storm	Action
com.mobirix.onepunch	One Finger Death Punch	Action
com.mobirix.playmaze	Maze Challenge	Arcade
com.mobirix.SnakeGame	Snakes & Ladders King	Board
com.mobirix.tkochess.wgmf	The King of Chess	Board
com.mobirix.ttt_gg	TicTacToe King	Board
com.mobisystems.fileman	File Commander - File Manager	Business
com.mobisystems.mobiscanner	Quick PDF Scanner FREE	Business
com.mobisystems.msdict.embedded.wireless.mcgrawhill.investopedia	The (I) Investopedia Guide	Libraries & Demo
com.mobisystems.msdict.embedded.wireless.oxford.concisemedical	Oxford Medical Dictionary TR	Medical
com.mobisystems.msdict.embedded.wireless.oxford.dictionaryofenglish	Oxford Dictionary of English T	Books & Reference
com.mobisystems.msdict.embedded.wireless.wordnet	Advanced English & Thesaurus	Books & Reference
com.mobisystems.office	OfficeSuite 8 + PDF Converter	Business
com.mobisystems.ubreader_west	Universal Book Reader	Books & Reference
com.modiface.haircolorstudio.free	Hair Color Studio	Photography
com.modoohut.dialer	ExDialer - Dialer & Contacts	Communication
com.mohitdev.minebuild	Minebuild	Casual
com.mojo.animewallpaper	ANIME GIRLS WALLPAPER	Comics
com.momdeveloper.octonautsvideos	The Octonauts Videos	Comics
com.monarcy.golden	Golden Sand Slots	Casino
com.monefy.app.lite	Monefy - Money Manager	Finance
com.monster.android.Views	Monster Job Search	Business
com.MoNTE48.MultiCraft2	MultiCraft II — Free Miner!	Adventure
com.montrealcanadiens.Canadiens	Canadiens de Montréal	Sports
com.moplus.gvphone	PHONE for Google Voice & GTalk	Communication
com.moplus.moplusapp	Free Calls & Text by Mo+	Communication
com.mostafiz.ovulation	Ovulation Calendar & Fertility	Medical
com.motorbike.driving.simulator	Motorbike Driving Simulator 3D	Racing
com.move.realtor	Realtor.com Real Estate, Homes	Lifestyle
com.movisoftnew.videoeditor	Video Editor	Media & Video
com.mp.snowmobileparking	SnowMobile Parking Adventure	Racing
com.mp.snowmobilerescue	Snowmobile Rescue Missions 3D	Simulation
com.mss.doublediamond	Double Diamond Slot Machine	Casino
com.mufumbo.android.recipe.search	Cookpad Recipes	Health & Fitness
com.muhanov	Workout Timer	Sports
com.music.player.mp3player.white	MP3 Player	Music & Audio
com.musicmaniac.music.player	MP3 Player	Music & Audio
com.musixmatch.android.lyrify	musixmatch music & lyrics	Music & Audio
com.mxtech.ffmpeg.tegra3	MX Player Codec (Tegra3)	Libraries & Demo
com.mxtech.ffmpeg.v5te	MX Player Codec (ARMv5)	Libraries & Demo
com.mxtech.ffmpeg.v6	MX Player Codec (ARMv6)	Libraries & Demo
com.mxtech.ffmpeg.v6_vfp	MX Player Codec (ARMv6 VFP)	Libraries & Demo
com.mxtech.ffmpeg.v7_neon	MX Player Codec (ARMv7 NEON)	Libraries & Demo
com.mxtech.ffmpeg.v7_vfpv3d16	MX Player Codec (ARMv7)	Libraries & Demo
com.mxtech.videoplayer.ad	MX Player	Media & Video
com.my.irondesert	Iron Desert–Christmas Edition	Strategy
com.my.mail	myMail—Free Email Application	Communication
com.myappatory.busbuddy	BusBuddy Ottawa	Transport
com.myboyfriendisageek.videocatcher.demo	AVD Download Video Downloader	Media & Video
com.mycolorscreen.themer	Themer: Launcher, HD Wallpaper	Personalisation
com.myfitnesspal.android	Calorie Counter - MyFitnessPal	Widgets
com.myhomeowork	myHomework Student Planner	Education
com.myleaderboard.GolfChannel	Golf Channel Mobile	Sports
com.mystylinglounge.android_glamdoll	Glam Doll Makeover- My Girl	Family
com.mystylinglounge.android_princess_salon2	Princess Salon™ 2	Family
com.myyearbook.m	MeetMe: Chat & Meet New People	Social
com.namcobandaigames.pacmandash.v01	PAC-MAN DASH!	Action
com.namcobandaigames.pacmantournaments	PAC-MAN +Tournaments	Arcade
com.naquatic.hockeyshowdown	Hockey Showdown	Sports
com.naresdeloper.superwallpapers	Super Wallpapers	Comics
com.natenai.glowhockey	Glow Hockey	Arcade
com.natenai.glowhockey2	Glow Hockey 2	Arcade
com.natenai.virtualhorseracing3d	Virtual Horse Racing 3D	Card
com.naturalmotion.clumsyninja	Clumsy Ninja	Family
com.naturalmotion.csrclassics	CSR Classics	Racing
com.naturalmotion.csrracing	CSR Racing	Racing
com.naturalmotion.jenga	Jenga Free	Casual
com.naver.linewebtoon	LINE Webtoon	Comics
com.navfree.android.OSM.ALL	Navfree: Free GPS Navigation	Transport
com.nbaimd.gametime.nba2011	NBA GAME TIME	Sports
com.nekki.shadowfight	Shadow Fight 2	Action
com.nekki.vector	Vector	Arcade
com.nerdyoctopus.gamedots	Dots: A Game About Connecting	Casual
com.nestlabs.android	Nest	Lifestyle
com.netcosports.andjdm	J5 (JDM)	News & Magazines
com.netcosports.andjdq	J5 (JDQ)	News & Magazines
com.netcosports.andtvasecondscreen	TVA Sports Hockey	Sports
com.netflix.mediaclient	Netflix	Entertainment
com.netherfire.kingdomsiege	Kingdom Siege	Strategy
com.netherfire.PirateCasino	Pirate Casino: Baccarat	Casino
com.netmarble.chachachaf	Go!Go!Go!:Racer	Racing
com.netqin.ps	Vault-Hide SMS, Pics & Videos	Business
com.neulion.android.nfl.gamepass	NFL Game Pass	Sports
com.neulion.smartphone.ufc.android	UFC.TV & UFC FIGHT PASS	Sports
com.newgeneration.music.newred	Play Tube 2015	Education
com.newsandmedia.closerlook	How To Pearl With Less Peril	News & Magazines
com.newspaperdirect.jdm.market	Journal de Montréal - éditionE	News & Magazines
com.nexonm.loh.usios	Legion of Heroes	Role Playing
com.nexonm.monstersquad	Monster Squad	Role Playing
com.nexonm.orcs	Heroes of War: Orcs vs Knights	Strategy
com.nexstreaming.app.kinemasterfree	KineMaster – Pro Video Editor	Media & Video
com.nextbus.mobile	NextBus	Transport
com.nextradiotv.bfmtvandroid	BFMTV	News & Magazines
com.nextride.cts	TransitHub Calgary	Transport
com.nfl.now	NFL Now	Sports
com.nhl.gc1112.free	NHL	Widgets
com.nhl.gc1314.ott	Ottawa Senators Official App	Sports
com.nhl.gc1314.van	Vancouver Canucks	Sports
com.nhl.gc1314.wpg	The Winnipeg Jets App	Sports
com.nhl.hattrickchallenge	NHL Hat Trick Challenge	Sports
com.nhn.android.webtoon	네이버 웹툰 - Naver Webtoon	Comics
com.nhnent.SKLEGIONZUS	Battle for the Throne	Strategy
com.nhnent.SKQUEST	Crusaders Quest	Role Playing
com.nianticproject.ingress	Ingress	Adventure
com.nicedonegames.furiouscardriving	Furious Car Driving	Racing
com.nike.ntc	NIKE+ TRAINING CLUB	Health & Fitness
com.nike.plusgps	Nike+ Running	Health & Fitness
com.niksoftware.snapseed	Snapseed	Photography
com.nim.rogers	Next Issue Unlimited Magazines	News & Magazines
com.nimbleminds.everydaywordsfree	Words for Kids - Reading Games	Educational
com.ninegag.android.redheadredemption	9GAG Redhead Redemption	Action
com.ninetyfour.seconds.app	94 Seconds: category word game	Trivia
com.ninjakiwi.bloonstdbattles	Bloons TD Battles	Strategy
com.nll.screenrecorder	Screen Recorder	Media & Video
com.nobexinc.cbcradio.rc	CBC Radio	Music & Audio
com.noodlecake.blockheads	The Blockheads	Adventure
com.noodlecake.ssg2	Super Stickman Golf 2	Sports
com.noom.walk	Noom Walk Pedometer: Fitness	Health & Fitness
com.nopowerup.amazingpong	Amazing Pong	Adventure
com.nopowerup.amazingwire	Amazing Wire	Adventure
com.northpark.drinkwater	Water Your Body	Health & Fitness
com.northpark.pushups	Push Ups Workout	Health & Fitness
com.northpark.squats	Squats Workout	Health & Fitness
com.notabasement.mangarock.android.titan	Manga Rock - Best Manga Reader	Comics
com.notdoppler.earntodielite	Earn to Die Lite	Racing
com.nttsolmare.game.android.nfhef	Shall we date?: THE NIFLHEIM+	Adventure
com.nttsolmare.game.android.wihef	Shall we date?:WizardessHeart+	Adventure
com.nullapp.drumset	Drum set	Music
com.nullapp.guitar	Guitar	Music
com.nullapp.minipiano	Mini Piano	Music
com.nullapp.piano	Piano	Music
com.nullapp.racer.police	Police Car Driver 3D	Racing
com.nurun.lcn	TVA Nouvelles	News & Magazines
com.nurun.tva_sports	TVA Sports	Sports
com.nuttyapps.little.tailor	Little Tailor	Family
com.nuttyapps.princess.tailor	Princess Tailor Boutique	Role Playing
com.nwmodehp.WhiteTile	White Tile 4	Casual
com.nytimes.android	NYTimes - Breaking News	News & Magazines
com.o4games.android.ninjavspirate	Ninja VS Pirate	Role Playing
com.ocasi.cic.quiz	Canadian Citizenship Quiz	Education
com.oddyarts.StoneOfLifeEXNative	S.O.L : Stone of Life EX	Role Playing
com.ogien.trainsim	Train Sim	Simulation
com.ogqcorp.bgh	Backgrounds HD Wallpapers 50M+	Widgets
com.okcupid.okcupid	OkCupid Dating	Social
com.oki.colors	Learning colors for kids	Educational
com.oki.numbers	Kids games: learning numbers	Educational
com.oki.phonenew	Kids game: baby phone	Educational
com.oki.shapes	Kids games: Baby shapes	Educational
com.omgpop.dstfree	Draw Something Free	Word
com.ommdevil.android	1Mobile Market Lite	News & Magazines
com.onehundredpics.onehundredpicsquiz	100 PICS Quiz - FREE Quizzes	Word
com.onelouder.baconreader	BaconReader for Reddit	News & Magazines
com.oneup.mapleleafs	Maple Leafs Mobile	Sports
com.oneup.raptors	Raptors Mobile	Sports
com.onewinggame.guitarheroes	Guitar Heroes	Music
com.ontariog1examandroid	Ontario G1 Test Prep	Education
com.oodles.download.free.ebooks.reader	50000 Free Ebooks & Reader	Books & Reference
com.oovoo	ooVoo Video Call, Text & Voice	Social
com.opentable	OpenTable - Free Reservations	Lifestyle
com.opentech.tourpal	Travel guide / City Tour Guide	Travel & Local
com.opentext.bluefield	FirstClass Mobile	Business
com.opera.browser	Opera browser for Android	Communication
com.opera.mini.android	Opera Mini – Fast web browser	Communication
com.optiktv	Optik™ on the go	Media & Video
com.optimesoftware.checkers.free	Checkers Free	Board
com.optimesoftware.chess.free	Chess Free	Board
com.optimesoftware.fourinarow.free	Four in a Row Free	Board
com.optimesoftware.hangman.free	Hangman Free	Word
com.optimesoftware.tictactoe.free	Tic Tac Toe Free	Board
com.orbitz	Orbitz - Flights, Hotels, Cars	Travel & Local
com.outfit7.gingersbirthdayfree	Talking Ginger 2	Entertainment
com.outfit7.jigtyfree	Jigty Jigsaw Puzzles	Puzzle
com.outfit7.mytalkingangelafree	My Talking Angela	Casual
com.outfit7.mytalkingtomfree	My Talking Tom	Casual
com.outfit7.talkingangelafree	Talking Angela	Entertainment
com.outfit7.talkingben	Talking Ben the Dog Free	Entertainment
com.outfit7.talkinggingerfree	Talking Ginger	Entertainment
com.outfit7.talkingnewsfree	Talking Tom & Ben News Free	Entertainment
com.outfit7.talkingpierrefree	Talking Pierre the Parrot Free	Entertainment
com.outfit7.talkingsantafree	Talking Santa	Entertainment
com.outfit7.talkingsantagingerfree	Talking Santa meets Ginger	Entertainment
com.outfit7.talkingtom	Talking Tom Cat Free	Entertainment
com.outfit7.talkingtom2free	Talking Tom Cat 2 Free	Entertainment
com.outfit7.tomlovesangelafree	Tom Loves Angela	Entertainment
com.outfit7.tomslovelettersfree	Tom's Love Letters	Entertainment
com.outlook.Z7	Outlook.com	Communication
com.ovelin.guitartuna	Guitar Tuner Free - GuitarTuna	Tools
com.overdrive.mobile.android.mediaconsole	OverDrive	Books & Reference
com.ovilex.realdriving3d	Real Driving 3D	Racing
com.ovilex.trucksimulator3d	Truck Simulator 3D	Simulation
com.ovuline.fertility	Ovia Fertility and Ovulation	Medical
com.ovuline.pregnancy	Ovia Pregnancy Guide	Medical
com.p1.chompsms	chomp SMS	Communication
com.PacificBlueCross.nightingale	CARESnet Mobile	Medical
com.pacificinteractive.HouseOfFun	Slot Machines - House of Fun!	Casino
com.padmapper	PadMapper	Shopping
com.pakorn.modsminedownloadcraft	MODS DOWNLOAD MINE CRAFT 1.7.2	Education
com.panaceasupplies.android.reader	Free books to download & read	Books & Reference
com.papaqigame.Physics	Soccer Jumper	Action
com.patigames.ilovepasta4gsp	I LOVE PASTA	Simulation
com.paybyphone	PayByPhone	Travel & Local
com.paypal.android.p2pmobile	PayPal	Widgets
com.pcfinancial.mobile	PC Financial Mobile Banking	Finance
com.pearson.powerschool.android.student	PowerSchool for Students	Education
com.pelmorex.WeatherEyeAndroid	The Weather Network	Widgets
com.pennypop.monsters.live	Battle Camp	Role Playing
com.peoplefun.wordchums	Word Chums	Word
com.perfectpiano.keyboards.acousticbass	Acoustic Bass Sound Plugin	Music
com.perfectpiano.keyboards.eleguitar	Clean Electric Guitar Plugin	Music
com.perfectpiano.keyboards.flute	Flute Sound Plugin	Music
com.perfectpiano.keyboards.saporanosax	SopranoSax Sound Plugin	Music
com.perfectpiano.keyboards.stringensemble	String Ensemble Sound Plugin	Music
com.perfectpiano.keyboards.violin	Violin Sound Plugin	Music
com.perfectpiano.keyboards.yamahap200	HQ Grand Piano Sound Plugin	Music
com.period.tracker.lite	Period Tracker	Widgets
com.perk.screen	Perk Screen: Unlock & Win!	Productivity
com.pescapps.gamekidsfree	Kids Games Free - Education	Educational
com.phonegap.getpregnant	Get Pregnant	Medical
com.phyora.apps.reddit_now	Reddit Now	News & Magazines
com.picsart.studio	PicsArt Photo Studio	Photography
com.pikpok.mr.play	The Maze Runner	Action
com.pikpok.turbo	Turbo FAST	Racing
com.PinballGame	Pinball Pro	Board
com.ping9games.grabtheauto	Grab The Auto	Racing
com.pinger.textfree	Text Free SMS Texting App	Social
com.pinger.textfree.call	Text Free: Calling Texting App	Social
com.pinkpointer.crosswords	Crosswords	Word
com.pinkpointer.tictactoe	Tic Tac Toe	Board
com.pinkpointer.wordsearch	Word Search	Word
com.pinkpointer.wordsearch2	Word Search 2	Word
com.pinterest	Pinterest	Widgets
com.piriform.ccleaner	CCleaner	Tools
com.pisanu.scrabblechecker	Scrabble Checker	Word
com.pixel.gun3d	Pixel Gun 3D	Action
com.pixelberrystudios.hssandroid	High School Story	Simulation
com.pixelberrystudios.hwuandroid	Hollywood U: Rising Stars	Simulation
com.pixelsonfire.goaround	1000 ways to die in a circle	Arcade
com.pixign.premiumwallpapers	Premium Wallpapers HD	Personalisation
com.pixlr.express	Autodesk Pixlr – photo editor	Photography
com.pixowl.thesandbox.android	The Sandbox: Craft Play Share	Simulation
com.pizzapizza.production	Pizza Pizza	Lifestyle
com.pkdevmc.unofficialminecraftproz2014	UNOFFICIAL MINECRAFT PROS MINE	Libraries & Demo
com.plabs.planetofc	Planet of Cubes Online	Simulation
com.plantpurple.emojidom	Emojidom Smileys Emoji in Chat	Social
com.plarium.stormfallrob	Stormfall: Rise of Balur	Strategy
com.plarium.tdreborn	Total Domination - Reborn	Strategy
com.play.slot	Slot Casino - Slot Machines	Board
com.playdemic.villagelife.android	Village Life: Love & Babies	Adventure
com.playfirst.dinerdashx	Diner Dash	Casual
com.playmage.dragonera	Dragon Era - RPG Card Slots	Role Playing
com.playmobil.luxusvilla	PLAYMOBIL Luxury Mansion	Simulation
com.playmous.godoflight	God of Light	Puzzle
com.playrix.township	Township	Simulation
com.playsimple.roomtemperature	Room Temperature	Weather
com.playstation.petsapp	PS Vita Pets: Puppy Parlour	Family
com.playstudios.myvegas	myVEGAS Slots Free Casino	Casino
com.playstudios.myvegas.blackjack	Blackjack - myVEGAS 21 Free	Casino
com.playtika.caesarscasino	Caesars Slots	Casino
com.playtika.wsop.gp	World Series of Poker – WSOP	Card
com.playway.cms2014	Car Mechanic Simulator 2014	Simulation
com.playzot.grabbyWord	GrabbyWord	Word
com.plexapp.plex	Plex for Plex Pass	Media & Video
com.pliyr.music	Music Player by Perfect Media	Music
com.plusonelabs.doublemill	Doublemill 2 Nine men's morris	Board
com.pnimedia.android.photo.walca	Walmart Photo Prints (Canada)	Photography
com.pocketcraft.free.edition	Pocket Craft PokeCraft Edition	Arcade
com.pocketplay.PW1A	Phrase Wheel - Lucky Spin!	Word
com.pocketscientists.rmrio	Escape From Rio - Blue Birds	Adventure
com.poertyuio.dinocraft	Dino Craft	Adventure
com.pof.android	POF Free Dating App	Widgets
com.pokemonshowdown.app	Showdown!	Simulation
com.polertt.skyblock2222	Skyblock Survival	Adventure
com.polyvore	Polyvore: Shop, Style, Fashion	Lifestyle
com.popularapp.periodcalendar	Period Calendar / Tracker	Health & Fitness
com.popularapp.sevenmins	7 Minute Workout	Health & Fitness
com.popzhang.sudoku	Sudoku Master	Word
com.postmedia.calgaryherald.smartphone	Calgary Herald	News & Magazines
com.postmedia.ottawacitizen.android2	Ottawa Citizen	News & Magazines
com.potente.apk.installer	Apk Installer	Libraries & Demo
com.power.videocallingfree	Video Calling Free	Communication
com.PrankRiot	PRANKDIAL - #1 Prank Call App	Entertainment
com.priceline.android.negotiator	Priceline Hotels & Travel	Travel & Local
com.privateinternetaccess.android	VPN by Private Internet Access	Communication
com.production.truspertips	Trusper Tips	Lifestyle
com.progimax.airhorn.free	Stadium Horn	Sports
com.progrestar.bft	Throne Rush	Strategy
com.promedia.fishingparadise	Fishing Paradise 3D Free+	Sports
com.protrade.sportacular	Yahoo Sport	Sports
com.pureawesome.sov	Sounds of Vine - Soundboard	Entertainment
com.purolator.mobileapp	Purolator	Business
com.purologics.trackolia	Trackolia	Business
com.purplekiwii.mb	Monster Busters	Puzzle
com.pushbullet.android	Pushbullet	Productivity
com.pyrsoftware.pokerstars.net	PokerStars Poker: Texas Holdem	Card
com.qihoo.security	360 Security - Antivirus Boost	Tools
com.qiigame.flocker.global	Locker Master-FUN,HD THEMES	Personalisation
com.quanticapps.quranandroid	Muslim Quran Pro - Koran Coran	Libraries & Demo
com.Qublix.SolitaireAtlantis	Solitaire Atlantis	Card
com.Qublix.SolitaireTales	Solitaire Tales	Card
com.quebecechantillonsgratuits	Échantillons et rabais Québec	Shopping
com.quelaba.sopaletras	Word search	Puzzle
com.questrade.iq	Questrade IQ Mobile	Finance
com.questvisual.wordlens.demo	Word Lens Translator	Travel & Local
com.quickplay.android.bellmediaplayer	Bell TV	Media & Video
com.quickplay.rodo	Rogers Anyplace TV	Media & Video
com.quizapp.multitable	Math - Times Tables	Educational
com.quizlet.quizletandroid	Quizlet	Education
com.quizup.core	QuizUp	Trivia
com.quoord.tapatalkpro.activity	Tapatalk	Social
com.quran.labs.androidquran	Quran for Android	Books & Reference
com.quvideo.xiaoying	VivaVideo: Free Video Editor	Media & Video
com.qxmd.calculate	Calculate by QxMD	Medical
com.rabugentom.chordfree	Chord! Free (Guitar Chords)	Books & Reference
com.racerroadreckless.extremehighwaystuntdriver	Traffic Jammer 3D - Car Racing	Racing
com.radio.fmradio	Radio FM	Music & Audio
com.radiocanada.android	Radio-Canada	News & Magazines
com.rami.puissance4	Connect 4 Pro	Family
com.randomlogicgames.guesstheemojimovies	Guess The Emoji - Movies	Trivia
com.randomlogicgames.guesstheword	Guess The Word!	Word
com.rapala.lures	Rapala Lure Selector	Sports
com.rarlab.rar	RAR for Android	Tools
com.rayark.Cytus.full	Cytus	Music
com.rayark.pluto	Deemo	Music
com.rbc.mobile.android	RBC Mobile	Finance
com.rcplatform.nocrop	No Crop for Instagram	Photography
com.rdio.android.ui	Rdio Music	Widgets
com.rds.multisports	RDS GO	Sports
com.realbyteapps.moneymanagerfree	Money Manager Expense & Budget	Finance
com.rebelbinary.onlyone	Only One	Role Playing
com.rebelvox.voxer	Voxer Walkie Talkie Messenger	Communication
com.redcactus.repost	Repost for Instagram	Social
com.reebee.reebee	reebee	Productivity
com.reliancegames.urf	Ultimate Robot Fighting	Action
com.remind101	Remind: Free, Safe Messaging	Education
com.repost	InstaRepost - Repost Instagram	Social
com.retrodreamer.IceCreamJump.android.free	Ice Cream Jump	Casual
com.Revsoft.Wabbitemu	Wabbitemu	Education
com.rhmsoft.fm	File Manager (Explorer)	Tools
com.rikkigames.solsuite	Solitaire	Card
com.riovox.gog	Block Force - Cops N Robbers	Action
com.rkgames.breakfast	Impossible Breakfast Simulator	Simulation
com.roblox.client	ROBLOX	Adventure
com.robtopx.geometryjumplite	Geometry Dash Lite	Arcade
com.RocketGames.JungleSlots	Slots Super Gorilla Free Slots	Casino
com.rockstargames.ifruit	Grand Theft Auto: iFruit	Action
com.rogers.citynews	CityNews Toronto	News & Magazines
com.rogers.citytv.phone	City Video	Media & Video
com.rogers.news680	680 News	News & Magazines
com.rogers.sportsnet.sportsnet	Sportsnet	Sports
com.rogers.sportsnetnow	Sportsnet Now	Sports
com.roidapp.photogrid	Photo Grid - Collage Maker	Photography
com.roku.remote	Roku	Entertainment
com.rookiestudio.perfectviewer	Perfect Viewer	Comics
com.rookiestudio.perfectviewer.pdfplugin	Perfect Viewer PDF Plugin	Comics
com.roommate.app.activity	Wallpaper HD Plus	Personalisation
com.rottzgames.realjigsaw	Real Jigsaw Puzzles Free	Puzzle
com.roularta.lexpress	L'Express actu en continu	News & Magazines
com.rounds.android	Rounds Video Chat, Call & Text	Communication
com.rovio.angrybirds	Angry Birds	Arcade
com.rovio.angrybirdsfriends	Angry Birds Friends	Arcade
com.rovio.angrybirdsgo	Angry Birds Go!	Racing
com.rovio.angrybirdsrio	Angry Birds Rio	Arcade
com.rovio.angrybirdsseasons	Angry Birds Seasons	Arcade
com.rovio.angrybirdsspace.ads	Angry Birds Space	Arcade
com.rovio.angrybirdsstarwars.ads.iap	Angry Birds Star Wars	Arcade
com.rovio.angrybirdsstarwarsii.ads	Angry Birds Star Wars II Free	Arcade
com.rovio.angrybirdsstella	Angry Birds Stella	Arcade
com.rovio.angrybirdstransformers	Angry Birds Transformers	Arcade
com.rovio.BadPiggies	Bad Piggies	Puzzle
com.rovio.gold	Angry Birds Epic	Role Playing
com.rsg.pictsf	Logo Quiz	Board
com.rtp.livepass.android	Whistler Blackcomb Live	Sports
com.ruanshaomin.game	Unblock Car	Strategy
com.rubicon.dev.yachty	Yachty Deluxe FREE	Board
com.rubycell.perfectguitar	Guitar +	Music & Audio
com.rubycell.pianisthd	Piano Teacher	Music & Audio
com.runtastic.android	Runtastic Running & Fitness	Widgets
com.runtastic.android.pedometer.lite	Runtastic Pedometer	Health & Fitness
com.runtastic.android.sleepbetter.lite	Sleep Better with Runtastic	Health & Fitness
com.rushmo.casinofrenzy	Casino Frenzy	Casino
com.ryerson.go	GO Mobile	Transport
com.s2dio.automath	AutoMath Photo Calculator	Education
com.saavn.android	Saavn: Hindi & Bollywood Songs	Music & Audio
com.sabre.tripcase.android	TripCase Travel Alerts	Travel & Local
com.sabzira.PianoTiles	Piano Tiles	Casual
com.samj.CardTest	CardTest	Libraries & Demo
com.samkasem.legocoloringbatmankids	Lego Coloring Batman Kids	Educational
com.samremote.view	Remote for Samsung TV	Tools
com.samsung.samsungcatalog	Samsung TV	Business
com.sand.airdroid	AirDroid - Android on Computer	Tools
com.sap.mdc.loblaw.nativ	PC Plus	Lifestyle
com.saq.android	SAQ	Lifestyle
com.scaleasw.powercalc	Scientific Calculator	Tools
com.scannerradio	Scanner Radio	Entertainment
com.scee.psxandroid	PlayStation®App	Entertainment
com.ScnStudios.RealCityCarDriver3D	Real City Car Driver 3D	Racing
com.scoompa.collagemaker	Photo Collage Maker	Photography
com.scopely.slotsvacation	Slots Vacation - FREE Slots	Casino
com.scotiabank.mobile	Scotiabank Mobile Banking	Finance
com.scottgames.fnaf2demo	Five Nights at Freddy's 2 Demo	Strategy
com.scribd.app.reader0	Scribd - Read Unlimited Books	Books & Reference
com.scripps.android.foodnetwork	Food Network In the Kitchen	Lifestyle
com.sd.google.helloKittyCafe	Hello Kitty Cafe	Board
com.sdkjy.prezitutorial	Prezi Tutorial Free	Libraries & Demo
com.sec.android.easyMover	Samsung Smart Switch Mobile	Tools
com.secretexit.dismount	Stair Dismount	Arcade
com.secretexit.turbodismount	Turbo Dismount™	Simulation
com.seekingalpha.webwrapper	SA Stock Market News	Finance
com.sega.sonic.transformed	Sonic Racing Transformed	Racing
com.sega.sonicdash	Sonic Dash	Arcade
com.sega.sonicjumpfever	Sonic Jump Fever	Action
com.sei.android	7-Eleven, Inc.	Lifestyle
com.selfawaregames.acecasino	Big Fish Casino - Free SLOTS	Casino
com.sensedevil.VTT	Virtual Table Tennis	Sports
com.Seriously.BestFiends	Best Fiends	Puzzle
com.setsnail.daddylonglegs	Daddy Long Legs	Arcade
com.sfglobe.sfgmobile	SFG Mobile	News & Magazines
com.sgg.collapse2	1 Pic 1 Clue: Word Search Game	Word
com.sgg.pics2	4 Pics 1 Word Puzzle Plus	Word
com.sgg.pics_fr	4 Images 1 Mot:Quel est le mot	Word
com.sgiggle.production	Tango Messenger, Video & Calls	Social
com.sgn.pandapop.gp	Panda Pop	Puzzle
com.sharkparty.bingo	Bingo™	Casino
com.sharkparty.slots	Slots™	Casino
com.shatteredpixel.shatteredpixeldungeon	Shattered Pixel Dungeon	Role Playing
com.shaw.wififinder	Shaw Go WiFi Finder	Travel & Local
com.shawmedia.smglobal	Global Go	Entertainment
com.shazam.android	Shazam	Widgets
com.shomi.phone	shomi_ for phone	Entertainment
com.shomi.tablet	shomi_ for tablet	Entertainment
com.shootbubble.bubbledexlue	Shoot Bubble Deluxe	Puzzle
com.shopping.flyers	Shopping Flyers Canada	Shopping
com.shortapps.ctmoneytrack	Canadian Tire Money Tracker	Finance
com.showbox.showbox	Showbox	Lifestyle
com.sidheinteractive.sif.DR	Into the Dead	Action
com.sigmagame.imonster	Bulu Monster	Role Playing
com.simplygood.ct	Canadian Tire	Shopping
com.singlesaroundme.android	Singles AroundMe Local Dating	Social
com.sinkpoint.nextTTC	Next TTC	Transport
com.siri.budgetdemo	Home Budget Manager Lite	Finance
com.siriusca	SiriusXM Canada Internet Radio	Music & Audio
com.sirma.mobile.bible.android	Bible	Widgets
com.sixwaves.pandora	Slots - Pandora Myth	Casino
com.skgames.trafficracer	Traffic Racer	Racing
com.skimble.workouts	Workout Trainer	Health & Fitness
com.skinsappza.skinsminecraftpeproze	Skins Minecraft PE PROz	Books & Reference
com.skiplagged	Skiplagged = Cheap Flights	Travel & Local
com.skireport	OnTheSnow Ski & Snow Report	Sports
com.skollabs.funny	Funny Pics LOL!	Comics
com.skout.android	Skout - Meet, Chat, Friend	Social
com.SkyDivers.asteroids3d	Asteroids 3D live wallpaper	Personalisation
com.skyhealth.fitnessbuddyandroidfree	Fitness Buddy : 300+ Exercises	Health & Fitness
com.skyhealth.glucosebuddyfree	Glucose Buddy : Diabetes Log	Medical
com.skype.android.access	Skype WiFi	Travel & Local
com.skype.raider	Skype - free IM & video calls	Communication
com.skytech.omnivoxmobile	Omnivox Mobile	Education
com.Slack	Slack	Business
com.slacker.radio	Slacker Radio	Music & Audio
com.sleepingbeastgames.spaceteam	Spaceteam	Family
com.slotsfavorites.slots.android	SLOTS FAVORITES: Vegas Slots	Casino
com.slotsromance.slots.android.free	Slots Romance™: NEW SLOTS GAME	Casino
com.smartmobilesoftware.voicetranslatorfree	Voice Translator Free	Travel & Local
com.smashatom.blackjack	Blackjack 21+ Casino Card Game	Card
com.smilerlee.solitaire	Solitaire Classic	Card
com.smosh.foodbattle	Food Battle: The Game	Adventure
com.smsrobot.period	Period & Ovulation Tracker	Medical
com.smule.autorap	AutoRap by Smule	Music & Audio
com.smule.magicpiano	Magic Piano by Smule	Music & Audio
com.smule.singandroid	Sing! Karaoke by Smule	Music & Audio
com.snakesandladders.game	Snakes and Ladders	Board
com.snapchat.android	Snapchat	Social
com.SneakyGames.ArenaOfHeroes	Arena of Heroes	Strategy
com.snkplaymore.android003	METAL SLUG DEFENSE	Strategy
com.snowbao.purepiano	Pure Piano - Play "All of Me"	Music
com.sobeys	Sobeys	Shopping
com.socialnmobile.dictapps.notepad.color.note	ColorNote Notepad Notes To do	Productivity
com.socialnmobile.hd.flashlight	Color Torch HD LED flash light	Tools
com.socialquantum.acityint	Megapolis	Strategy
com.socrative.student	Socrative Student	Education
com.softcraft.englishbible	Holy Bible Offline	Books & Reference
com.softkiwi.waverun.android	WaveRun	Arcade
com.solvus_lab.android.BibleEN_nkjv	Holy Bible (NKJV)	Books & Reference
com.sonos.acr	Sonos Controller for Android	Music & Audio
com.sony.playmemories.mobile	Remote app:PlayMemories Mobile	Media & Video
com.sony.singstar	SingStar™ Mic	Music
com.sony.snei.mu.phone	Music Unlimited Mobile App	Music & Audio
com.sony.tvsideview.phone	Quick remote:TV SideView Sony	Media & Video
com.sonyericsson.digitalclockwidget2	Digital Clock Widget Xperia	Personalisation
com.sonyericsson.trackid	TrackID™	Music & Audio
com.sonypicturestelevision.sportsjeopardy	Sports Jeopardy!	Trivia
com.soundcloud.android	SoundCloud - Music & Audio	Widgets
com.soundhousellc.preschoolfree	ABC PreSchool Playground Free	Education
com.spaceapegames.samuraisiege	Samurai Siege	Strategy
com.sparklingsociety.cityisland	City Island ™: Builder Tycoon	Simulation
com.sparklingsociety.cityisland2	City Island 2 - Building Story	Simulation
com.sparklingsociety.cityisland3	City Island 3 - Building Sim	Simulation
com.speaktoit.assistant	Assistant	Lifestyle
com.speed.a.clean	Clean & Boost (Speed up RAM)	Tools
com.speed.roads	Speed Roads 3D	Racing
com.splashtop.remote.pad.v2	Splashtop 2 Remote Desktop	Business
com.sportstracklive.stopwatch	Stopwatch & Timer	Tools
com.spotify.music	Spotify Music	Widgets
com.spreadsong.freebooks	Free Books - 23,469 classics	Books & Reference
com.spx.ing004.google.s0	Galaxy at War Online	Strategy
com.squareup	Square Register	Business
com.srbd.ml2fdt.vr.environment	Cardboard VR 3D Environment	Libraries & Demo
com.srsdev.allfacts	Funny Facts Free 8000+	Comics
com.stac.empire.main	Age of Warring Empire	Role Playing
com.stac.rts	Empire Siege	Strategy
com.stainlessgames.D15	Magic 2015	Card
com.starbucks.mobilecard	Starbucks	Lifestyle
com.starmakerinteractive.thevoice	The Voice: On Stage	Music & Audio
com.stingray.galaxie.android	Stingray Music	Music & Audio
com.StormLiveWallpaperHD	Storm Live Wallpaper	Personalisation
com.streema.simpleradio	Simple Radio by Streema	Music & Audio
com.stubhub	StubHub - Tickets for Events	Entertainment
com.studio7775.BeatMP3	BEAT MP3 - Rhythm Game	Music
com.studio7775.BeatMP3v2	BEAT MP3 2.0 - Finger Dance	Music
com.studio8apps.instasizenocrop	Square InstaPic - No Crop HD	Photography
com.summtech.nivbible	NIV Bible	Books & Reference
com.sunix.lwp.snowmiku	Snow Miku Live Wallpaper	Comics
com.sunlife.ca.mysunlife	my Sun Life (Canada)	Finance
com.SuperAwesome.DreamTapper	Dream Tapper : Tapping RPG	Role Playing
com.supercell.boombeach	Boom Beach	Strategy
com.supercell.clashofclans	Clash of Clans	Strategy
com.supercell.hayday	Hay Day	Family
com.superdroid.sqd	Super SMS Quick Delete	Libraries & Demo
com.superlauncher.mobile.launcher8.pro	8 Launcher	Personalisation
com.supersolid.adventuretown	Adventure Town	Adventure
com.surpax.ledflashlight.panel	Super-Bright LED Torch	Productivity
com.sviluppo4mobile.GuessThatCelebrity	Guess That Celebrity	Trivia
com.svox.classic	Classic Text To Speech Engine	Libraries & Demo
com.svox.langpack.installer	SpeechSynthesis Data Installer	Libraries & Demo
com.sybase.atb	ATB Mobile Banking	Finance
com.sydneyapps.remotecontrol	Remote Control for TV	Tools
com.sygic.aura	GPS Navigation & Maps Sygic	Travel & Local
com.symantec.mobilesecurity	Norton Security and Antivirus	Tools
com.symbolic.pitchlab	PitchLab Guitar Tuner (LITE)	Music & Audio
com.szyk.myheart	Blood Pressure (My Heart)	Medical
com.tabtale.babyhousechores	Baby Home Adventure Kids' Game	Educational
com.tabtale.babytreehouse	Baby Tree House	Family
com.tabtale.eyedoctor	Crazy Eye Clinic - Doctor X	Role Playing
com.tabtale.fashionstar	Princess Fashion Star Contest	Family
com.tabtale.newbaby	My Newborn - Mommy & Baby Care	Role Playing
com.tabtale.princesshelper	Princess Little Helper	Family
com.tabtale.royalrescue	Fairytale Fiasco- Royal Rescue	Casual
com.taggedapp	Tagged - Meet, Chat, Flirt	Social
com.talkatone.android	Talkatone free calls & texting	Communication
com.talkray.client	Talkray - Free Calls and Text	Communication
com.tap4fun.galaxyempire2_android	Galaxy Legend	Role Playing
com.tap4fun.islandraiders	Island Raiders: War of Legends	Strategy
com.tap4fun.spartanwar	Spartan Wars: Empire of Honor	Strategy
com.tapblaze.nailsalonmakeover	Nail Salon Makeover	Family
com.tapcash.tapcash	Tap Cash Rewards - Make Money	Shopping
com.tapinator.simulator.duty.cop	Cop Duty Simulator 3D	Racing
com.tapinator.truck3d.snowblower	Snow Blower Truck Sim 3D	Simulation
com.tappple.followersplus	Followers+ for Instagram	Social
com.tapsarena.guess	Guess the word ~ 4 pics 1 word	Word
com.tapsarena.music	Music Quiz	Word
com.tarekmongy.FlappyCrush	Flappy Crush	Action
com.tarsin.android.dilbert	Dilbert Mobile	Comics
com.td	TD (Canada)	Finance
com.td.android	TD Mobile POS	Finance
com.tdcanada.mobileapp	TD (Tablet)	Finance
com.teachersparadise.abcflashcardsforkids	ABC Flash Cards for Kids	Educational
com.teachersparadise.kidsfingerpaintingcoloring	Kids Finger Painting Art Game	Educational
com.teachersparadise.mathpractice	Math Practice Flash Cards	Educational
com.teachersparadise.scratchdraw	Scratch Draw Art Game	Educational
com.teamlava.bakerystory	Bakery Story™	Casual
com.teamlava.bubble	Bubble Mania™	Arcade
com.teamlava.candy	Candy Blast Mania	Arcade
com.teamlava.farmthree	Farm Story 2	Simulation
com.teamlava.farmthree41	Farm Story 2: Winter	Simulation
com.teamlava.fashionstory	Fashion Story™	Casual
com.teamlava.fruitsplash	Fruit Splash Mania	Arcade
com.teamlava.jewel	Jewel Mania™	Arcade
com.teamlava.matchbakery	Cupcake Mania™	Arcade
com.teamlava.petshop	Pet Shop Story™	Casual
com.teamlava.petshop40	Pet Shop Story: Renaissance	Simulation
com.teamlava.restaurantstory	Restaurant Story™	Casual
com.teamsnap.teamsnap	Sport Team Management-TeamSnap	Sports
com.teamviewer.teamviewer.market.mobile	TeamViewer for Remote Control	Productivity
com.techsmith.apps.coachseye.free	Coach's Eye	Sports
com.ted.android	TED	Education
com.teerstudios.abschallenge	30 Day Ab Challenge FREE	Health & Fitness
com.tektrifyinc.fastfollowandroid	FastFollow for Instagram	Social
com.telltalegames.fables100	The Wolf Among Us	Adventure
com.telltalegames.walkingdead100	The Walking Dead: Season One	Adventure
com.telltalegames.walkingdead200	The Walking Dead: Season Two	Adventure
com.telus.myaccount	TELUS My Account	Productivity
com.temple.traingame	Temple Train Game	Action
com.tencent.mm	WeChat	Communication
com.tennumbers.animatedwidgetsfree	Weather Animated Widgets Free	Weather
com.teslacoilsw.launcher	Nova Launcher	Personalisation
com.teslacoilsw.notifier	TeslaUnread for Nova Launcher	Libraries & Demo
com.textmeinc.freetone	FreeTone Free Calls & Texting	Social
com.textmeinc.textme	Text Me!  Free Texting & Call	Communication
com.textra	Textra SMS	Communication
com.textra.emoji	Textra SMS iOS Emojis	Communication
com.texty.sms	SMS Text Messaging Texting SMS	Communication
com.the.best.android.crosswords.ever	Crosswords in English	Word
com.The2020Diet.Android	The 2020 Diet	Lifestyle
com.theglobeandmail.headliner	The Globe and Mail: News	News & Magazines
com.thegrizzlylabs.geniusscan.free	Genius Scan - PDF Scanner	Business
com.thehomedepotca	The Home Depot Canada	Shopping
com.thepandasteam.playtubedemo	PlayTube for YouTube free	Media & Video
com.thestar.www	Toronto Star	News & Magazines
com.thetransitapp.droid	Transit App: Live Bus & Tube	Transport
com.threed.bowling	3D Bowling	Sports
com.ticketmaster.mobile.android.na	Ticketmaster	Entertainment
com.timehop	Timehop	Social
com.timeplay	TimePlay	Entertainment
com.timeplusq.drawnguess	Draw N Guess Multiplayer	Word
com.tinder	Tinder	Lifestyle
com.tinyco.familyguy	Family Guy The Quest for Stuff	Adventure
com.TinyLabProductions.FunKidRacing	Fun Kid Racing	Racing
com.tinymission.dailyworkoutsfree	Daily Workouts FREE	Health & Fitness
com.tipytapy.babybirth	Little Newborn Baby Birth	Educational
com.tljtek.casino	25-in-1 Casino & Sportsbook	Card
com.tmarki.comicmaker	Rage Comic Maker	Comics
com.tmarki.comics	Comic Creator	Comics
com.tmsoft.whitenoise.lite	White Noise Lite	Health & Fitness
com.tocaboca.tocakitchen	Toca Kitchen	Education
com.todoist	Todoist: To-Do List, Task List	Productivity
com.tokensapp	TokensApp	Communication
com.topfreegames.bikeracefreeworld	Bike Race Free - Top Free Game	Action
com.tophat.android.app	Top Hat	Education
com.torontopearson	Toronto Pearson Airport	Travel & Local
com.torstar.wagjag	WagJag Daily Deals & Discounts	Shopping
com.touchfoo.swordigo	Swordigo	Adventure
com.touchtype.swiftkey	SwiftKey Keyboard + Emoji	Productivity
com.tour.pgatour	PGA TOUR	Sports
com.tp.android.footd	Little Foot Doctor- kids games	Casual
com.tp.android.lmaternitydoctor	Newborn Baby Doctor	Casual
com.tp.android.newborn	Newborn Baby Care - Mommy	Casual
com.tplink.tether	TP-LINK Tether	Libraries & Demo
com.tranzmate	Moovit: Next Bus & Train Info	Transport
com.travelocity.android	Travelocity Hotels & Flights	Travel & Local
com.travelzoo.android	Travelzoo	Travel & Local
com.tribeplay.pandabusxmas	Dr. Panda's Christmas Bus	Educational
com.trinitigame.android.miniwarriors	Mini Warriors	Strategy
com.tripadvisor.tripadvisor	TripAdvisor	Travel & Local
com.tripit	TripIt Travel Organizer – Free	Travel & Local
com.trivago	trivago The Hotel Search	Travel & Local
com.triviaburst.e5	Trivia Burst (Trivia Quiz)	Trivia
com.trtf.blue	Email Mail Exchange @Blue	Communication
com.truecaller	Truecaller - Caller ID & Block	Communication
com.trustlook.antivirus	Antivirus & Mobile Security	Productivity
com.truven.druginfonative.customer	Free Micromedex Drug Reference	Medical
com.tsavo.amipregnant	Pregnancy Test & Symptom Quiz	Medical
com.tscti.pixycraft	Pixycraft	Adventure
com.ttctracker.activity	TTC Tracker	Transport
com.ttt9217.powerrangerssamuraiwallpaper	Power Rangers Samurai HD	Comics
com.tul.aviate	Yahoo Aviate Launcher	Personalisation
com.tumblr	Tumblr	Widgets
com.turbochilli.unrollme	Unroll Me ™- unblock the slots	Puzzle
com.turborocketgames.wildwolf	Wild Wolf Simulator 3D	Simulation
com.twelvegigs.heaven.bingo	BINGO!	Casino
com.twitter.android	Twitter	Widgets
com.twominds.HeadsUpCharadas	What am I?	Word
com.tyedappsstudio.kissanime	Kiss Anime unofficial	Media & Video
com.ubercab	Uber	Transport
com.ubisoft.assassin.blackflag	Assassin’s Creed® IV Companion	Adventure
com.ubisoft.assassin.pirates	Assassin's Creed Pirates	Action
com.ubisoft.assassin.unity.companion	Assassin’s Creed® Unity App	Adventure
com.ubisoft.dance.JustDance	Just Dance Now	Music
com.ubisoft.dance.justdance2015companion	Just Dance 2015 Controller	Music
com.ubisoft.redlynx.trialsfrontier.ggp	Trials Frontier	Racing
com.UCMobile.intl	UC Browser for Android	Communication
com.ucool.hero	Heroes Charge	Role Playing
com.ucool.herohd	Heroes Charge HD	Role Playing
com.udemy.android	Udemy: Courses and Tutorials	Education
com.uk.best.cross.word.game	Crossword Puzzle Free	Word
com.uken.BingoPop	Bingo Pop	Card
com.umonistudio.tile	Don't Tap The White Tile	Arcade
com.unbound.android.ubnc2	Nursing Central	Medical
com.unii.fling	Fling - Message The World	Social
com.united.mobile.android	United Airlines	Travel & Local
com.universalpictures.dm2widget	DESPICABLE ME WEATHER WIDGET	Weather
com.universetoday.moon.free	Phases of the Moon Free	Weather
com.unlimitedcoinsrubest.ort	Unlimited Coins	Books & Reference
com.unofficialmcpeapp.minecraftmodsforpefree	Mods For Mine Craft PE 2014	Books & Reference
com.ups.mobile.android	UPS Mobile	Business
com.uptodate.android	UpToDate for Android	Medical
com.urbandictionary.android	Urban Dictionary (Official)	Books & Reference
com.urbandroid.lux	Twilight	Health & Fitness
com.urbandroid.sleep	Sleep as Android	Lifestyle
com.urbanspoon	Urbanspoon Restaurant Reviews	Travel & Local
com.usmann.whitagramforandroid	Whitagram for Android	Photography
com.usnaviguide.radar_now	RadarNow!	Weather
com.utorrent.client	µTorrent® - Torrent Downloader	Media & Video
com.vacationrentals.homeaway	HomeAway Holiday Rentals	Travel & Local
com.valvesoftware.android.steam.community	Steam	Entertainment
com.vancity.mobileapp	Vancity	Finance
com.vebinsedenst22k.bkmnn	Drawing Lessons Ollaf Frozen	Family
com.vectorunit.purple.googleplay	Beach Buggy Racing	Racing
com.vectorunit.yellow	Beach Buggy Blitz	Racing
com.venticake.retrica	Retrica	Photography
com.vevo	Vevo - Watch HD Music Videos	Music & Audio
com.vg.cartransporttrailertruck3d	3D Car transport trailer truck	Simulation
com.vg.constructionsimulator3D	City construction simulator 3D	Simulation
com.vg.FlightSimulatorAirplane3D	Flight Simulator Airplane 3D	Simulation
com.vg.limosim	Limo Driving 3D Simulator	Simulation
com.viber.voip	Viber	Communication
com.videofx	VideoFX Music Video Maker	Media & Video
com.videostream.Mobile	Videostream Chromecast: Remote	Media & Video
com.videotron.android.personas	Mobile usage	Tools
com.videotron.illicoweb	illico.tv	Media & Video
com.viewster.androidapp	Viewster – Free Movies & Shows	Entertainment
com.viiga.giftcard	Free Gift Cards	Lifestyle
com.virblue.mystudylife	My Study Life	Education
com.virgil.basketball	Basketball Mania	Sports
com.visiblebody.atlassp	Human Anatomy Atlas SP	Medical
com.visualtv.bkd.livesportstv	LiveSports Streaming	Sports
com.vitalsource.bookshelf	Bookshelf	Education
com.vividgames.realboxing	Real Boxing	Sports
com.vivitylabs.android.braintrainer	Fit Brains Trainer	Education
com.vizmanga.android	VIZ Manga	Comics
com.vladlee.easyblacklist	Calls Blacklist - Call Blocker	Communication
com.vodigitalarts.rallyracerdrift	Rally Racer Drift	Racing
com.vostu.minifazenda2	Top Farm	Simulation
com.voxofon	Free Calls & Text Messenger	Communication
com.vsco.cam	VSCO Cam®	Photography
com.vuze.torrent.downloader	Vuze Torrent Downloader	Media & Video
com.walkme.trivial.fr.lite	Trivial Quiz Français Gratuit	Trivia
com.wanelo.android	Wanelo Shopping	Shopping
com.watabou.pixeldungeon	Pixel Dungeon	Role Playing
com.WaterfallLiveWallpaperHDHQ	Waterfall Live Wallpaper	Personalisation
com.waveaccounting.receipts	Receipts by Wave	Finance
com.waze	Waze Social GPS Maps & Traffic	Widgets
com.wb.goog.batman.brawler2013	Batman Arkham Origins	Arcade
com.wb.goog.injustice	Injustice: Gods Among Us	Action
com.wb.headsup	Heads Up!	Word
com.wb.speedorz	LEGO® Speedorz™	Racing
com.wCOLORTHEELSA	COLOR THE ELSA	Educational
com.weather.Weather	The Weather Channel	Widgets
com.webmd.android	WebMD for Android	Health & Fitness
com.webprancer.google.garfieldpethospital	Garfield's Pet Hospital	Family
com.wegoi.revolt2multiplayer	RE-VOLT 2 : MULTIPLAYER	Racing
com.weheartit	We Heart It	Social
com.weightwatchers.mobile.enca	Weight Watchers® Canada Mobile	Health & Fitness
com.weplaydots.twodotsandroid	TwoDots	Puzzle
com.westjet	WestJet	Travel & Local
com.whaleshark.retailmenot	RetailMeNot Coupons	Shopping
com.whatsapp	WhatsApp Messenger	Communication
com.whatsapp.wallpaper	WhatsApp Wallpaper	Personalisation
com.wherecloud.android.var	Voyages à Rabais	Travel & Local
com.whethercurrentwar.keystore.avenuepost.advice	Candlelight Live Wallpaper	Lifestyle
com.whiteboardchamps.colorchangedna	Droid DNA Live Wallpaper	Personalisation
com.whiztools.ultimatecheats	Ultimate Cheats	Books & Reference
com.wikimediacom.wifidisplayhelper	Wifi Display (Miracast) Helper	Media & Video
com.william.duproprio	DuProprio Mobile	Lifestyle
com.williamsinteractive.goldfish	Gold Fish Casino Slots	Casino
com.williamsinteractive.jackpotparty	Jackpot Party Casino - Slots	Casino
com.winzip.android	WinZip – Zip UnZip Tool	Productivity
com.wishabi.flipp	Flipp - Flyers & Weekly Ads	Shopping
com.withbuddies.dice.free	Dice With Buddies™ Free	Board
com.wiziapp.app104331	Texture Packs - Minecraft PE	News & Magazines
com.wiziapp.app104340	Maps - Minecraft PE	News & Magazines
com.wiziapp.app104473	Mods - Minecraft PE	News & Magazines
com.wizz.crosswords	Crosswords	Word
com.wlwx.ma_explore2	Super Adventurer	Arcade
com.wonder	Elevate - Brain Training	Education
com.wordmobiles.bikeRacing	Bike Racing 3D	Racing
com.wordpress.drewdeveloper.canadajobssearch	Canada Jobs Search	Business
com.wordreference	WordReference.com dictionaries	Books & Reference
com.wordsmobile.baseball	Baseball Hero	Sports
com.wordsmobile.musichero	Music Hero	Music
com.wordsmobile.nfl	Fanatical American Football	Sports
com.workday.workdroidapp	Workday	Business
com.workpail.inkpad.notepad.notes	InkPad Notepad - Notes - To do	Tools
com.works.timeglass.logoquiz	Picture Quiz: Logos	Trivia
com.worldremit.android	WorldRemit Money Transfer	Finance
com.wrc.wordstorm.android	WordBuzz: Word Game	Word
com.wsandroid.suite	Free Security & Antivirus	Productivity
com.wsi.android.intellicast	Intellicast Weather	Weather
com.wsl.noom	Noom Coach: Weight Loss Plan	Health & Fitness
com.wte.view	Pregnancy Tracker	Health & Fitness
com.wunderground.android.weather	Weather Underground	Weather
com.wunderkinder.wunderlistandroid	Wunderlist: To-Do List & Tasks	Productivity
com.x3m.tx3	Trial Xtreme 3	Racing
com.xe.currency	XE Currency	Travel & Local
com.xiaad.android.thermometertrial	Thermometer (Free)	Weather
com.xiafy.magictricks	Learn Magic Tricks	Libraries & Demo
com.xinmei365.font	HiFont - Cool Font Text Free	Personalisation
com.xquadro.tabataTimer	Tabata HIIT Timer (Ad free)	Sports
com.xs.armysniper	Modern Sniper	Action
com.xvideostudio.videoeditor	VideoShow: Video Editor &Maker	Media & Video
com.yahoo.mobile.client.android.atom	Yahoo News Digest	News & Magazines
com.yahoo.mobile.client.android.fantasyfootball	Fantasy NFL, MLB, NBA & NHL	Sports
com.yahoo.mobile.client.android.finance	Yahoo Finance	Finance
com.yahoo.mobile.client.android.flickr	Flickr	Photography
com.yahoo.mobile.client.android.im	Yahoo Messenger	Communication
com.yahoo.mobile.client.android.mail	Yahoo Mail	Communication
com.yahoo.mobile.client.android.weather	Yahoo Weather	Weather
com.yahoo.mobile.client.android.yahoo	Yahoo	News & Magazines
com.yamlearning.geographylearning	World Map Countries Capitals	Trivia
com.yelp.android	Yelp	Travel & Local
com.yinzcam.nfl.seahawks	Seattle Seahawks Mobile	Sports
com.yinzcam.nhl.flames	Calgary Flames Mobile	Sports
com.yinzcam.nhl.oilers	Edmonton Oilers	Sports
com.yinzcam.PenguinsMobile	Pittsburgh Penguins Mobile	Sports
com.yodo1.crossyroad	Crossy Road	Action
com.yoga.pro.google.paid	Yoga.com	Health & Fitness
com.youdagames.gop3multiplayer	Governor of Poker3	Card
com.youku.phone	Youku-Movie，TV，cartoon，Music	Media & Video
com.youneedabudget.ynab.app.market	You Need A Budget (YNAB)	Finance
com.youthhr.phonto	Phonto - Text on Photos	Photography
com.ypg.find	YP.ca Yellow Pages Canada	Productivity
com.ypg.rfd	RedFlagDeals (RFD) - Official	Shopping
com.yummly.android	Yummly Recipes & Recipe Box	Lifestyle
com.yx.boxinghero	Punch Boxing 3D	Sports
com.zach.wilson.magic.app	Magic: Deck Builder	Comics
com.zaingz.odesk.whatstheanime	What's the Anime?	Trivia
com.Zeeppo.RockLife	Rock Life - Be a Guitar Hero	Music
com.zenstudios.castlestorm	CastleStorm - Free to Siege	Strategy
com.zentertain.photocollage	Photo Collage Editor	Photography
com.zentertain.photoeditor	Photo Editor Pro	Photography
com.zeptolab.ctr.ads	Cut the Rope FULL FREE	Puzzle
com.zeptolab.ctr2.f2p.google	Cut the Rope 2	Puzzle
com.zeptolab.ctrexperiments.ads	Cut the Rope: Experiments FREE	Puzzle
com.zeptolab.cuttheropexmas.google	Cut the Rope: Holiday Gift	Puzzle
com.zeptolab.timetravel.free.google	Cut the Rope: Time Travel	Puzzle
com.zeroteam.zerolauncher	ZERO Launcher-Boost,Theme	Productivity
com.zgz.supervideo	Video Player for Android	Media & Video
com.zindagigames.test	Crazy Kitchen	Puzzle
com.zinio.mobile.android.reader	Zinio: 5000+ Digital Magazines	News & Magazines
com.zodinplex.abc.kids.letters.educational.sounds.baby	Educational Games for Kids	Education
com.zoemob.gpstracking	Cell phone tracker	Social
com.Zonmob.TowerDefense	Galaxy Defense	Strategy
com.zoodles.kidmode	Kid Mode: Free Games + Lock	Education
com.zoosk.zoosk	Zoosk - #1 Dating App	Social
com.zulily.android	zulily	Shopping
com.zumobi.msnbc	NBC News	News & Magazines
com.zuresoft.preguntadoswins	Preguntados Wins	Trivia
com.zuuks.city.driving	City Driving 3D	Racing
com.zwigglers.android.horoscopes	Horoscopes + daily fortune	Lifestyle
com.zynga.chess.googleplay	Chess With Friends Free	Board
com.zynga.draw2.googleplay.free	Art With Friends Free	Word
com.zynga.farmarcade	FarmVille: Harvest Swap	Puzzle
com.zynga.FarmVille2CountryEscape	FarmVille 2: Country Escape	Family
com.zynga.gswf	What’s the Phrase Free	Word
com.zynga.hititrich	Hit it Rich! Free Casino Slots	Casino
com.zynga.livepoker	Zynga Poker – Texas Holdem	Casino
com.zynga.livepokerclassic	Zynga Poker Classic TX Holdem	Casino
com.zynga.looney	Looney Tunes Dash!	Casual
com.zynga.scramble	Scramble With Friends Free	Word
com.zynga.wizardofoz	Wizard of Oz Slots Free Casino	Casino
com.zynga.wordsontour	Words On Tour	Word
com.zynga.wwf2.free	New Words With Friends	Word
coolcherrytrees.games.reactor	2 Player Reactor (Multiplayer)	Family
cz.aponia.bor3	GPS Navigation BE-ON-ROAD	Travel & Local
de.androidcrowd.logoquiz	Logo Quiz Ultimate	Trivia
de.aracom.remotecontrolapp	Sharp Remote	Libraries & Demo
de.habanero.quizoid	Quizoid (Quiz and Trivia)	Trivia
de.joergjahnke.documentviewer.android.free	Office Documents Viewer (Free)	Business
de.lotum.whatsinthefoto.fr	4 Images 1 Mot	Word
de.lotum.whatsinthefoto.us	4 Pics 1 Word	Word
de.lotumapps.truefalsequiz.us	True or False: Quiz Battle	Trivia
de.mobilebits.soulcraft2	SoulCraft 2 - Action RPG	Role Playing
de.mobilebits.soulcraftdefault	SoulCraft - Action RPG (free)	Role Playing
de.motain.iliga	Onefootball - Pure Football!	Sports
de.saschahlusiak.freebloks	Freebloks 3D	Board
de.stefanpledl.localcast	LocalCast for Chromecast/DLNA	Media & Video
de.stocard.stocard	Stocard - Loyalty Cards	Shopping
deezer.android.app	Deezer Music	Music & Audio
digifit.virtuagym.client.android	Fitness - Home & Gym Workouts	Health & Fitness
dk.boggie.madplan.android	Food Planner	Lifestyle
DOCECG2.doctor	Electrocardiogram ECG Types	Medical
emoji.keyboard.emoticonkeyboard	Emoji Keyboard -Cute,Emoticons	Live Wallpaper
ephime.mangapanda	Manga Panda	Comics
erseco.soft	Trivial Mobile	Trivia
es.socialpoint.DragonCity	Dragon City	Simulation
es.socialpoint.MonsterLegends	Monster Legends	Simulation
eu.sandcastle.android.childrenPiano	Children Piano	Music
example.matharithmetics	Math Tricks	Education
factory.widgets.SenseClock	Sense Analog Clock Widget	Weather
factory.widgets.ThreeDDigitalWeatherClock	3D Digital Weather Clock	Weather
flag.quiz.world.national.names.learn	Logo Quiz - World Flags	Trivia
flash290a.install.mobile	Install Flash Player Mobile	Educational
flipboard.app	Flipboard: Your News Magazine	News & Magazines
fr.nghs.android.dictionnaires	Offline dictionaries	Books & Reference
fr.playsoft.lefigarov3	Le Figaro.fr	News & Magazines
fr.telemaque.horoscope	Horoscope	Lifestyle
freemoviesapp.com	Free Movies	Media & Video
games.kids.infantiles	Games for kids (2,3,4 age)	Educational
gbis.gbandroid	GasBuddy - Find Cheap Gas	Travel & Local
ginlemon.flowerfree	Smart Launcher 2	Personalisation
ginlemon.smartlauncher.extratool	Smart Launcher Extra	Libraries & Demo
ginlemon.smartlauncher.notifier	Smart Launcher Notifications	Libraries & Demo
goldenshorestechnologies.brightestflashlight.free	Brightest Flashlight Free ®	Tools
gov.nasa	NASA App	Education
guess.the.brand.logo.quiz.icomania	Guess The Brand - Logo Mania	Trivia
home.solo.launcher.free	Solo Launcher - Clean & Clever	Personalisation
home.solo.plugin.weather	Solo Weather(Beta)	Weather
hotspotshield.android.vpn	Free VPN: Hotspot Shield VPN	Tools
hr.podlanica	Music Volume EQ	Music & Audio
hu.appcoder.solitaire	Solitaire	Card
hu.tonuzaba.android	Photo Warp	Entertainment
icomania.guess.the.icon.quiz.iconpopquiz.popiconquiz	Icomania Guess The Icon Quiz	Trivia
ie.bluebear.shavesanta	Shave Santa	Family
ie.rational.services.rush.poker.net	Full Tilt Poker - Texas Holdem	Card
info.androidz.horoscope	Daily Horoscope	Lifestyle
io.vov.vitamio	Vitamio Plugin ARMv7+NEON	Libraries & Demo
ipnossoft.rma.free	Relax Melodies: Sleep & Yoga	Health & Fitness
ipnossoft.rma.oriental	Relax M Meditation: Sleep Yoga	Health & Fitness
it.b77.pianomasterfree	Piano Master FREE	Music
it.mm.android.relaxrain	Relax Rain - Nature sounds	Lifestyle
it.rortos.extremelandings	Extreme Landings	Simulation
itembox.crayfish.x	Casino X - Free Online Slots	Casino
iwantbandit.com.android.tolbahady	Mobile Bandit	Shopping
je.fit	JEFIT Workout Exercise Trainer	Health & Fitness
jp.co.canon.bsd.ad.pixmaprint	PIXMA/MAXIFY PrintingSolutions	Tools
jp.co.canon.oip.android.opal	Canon Mobile Printing	Productivity
jp.co.johospace.jorte	Jorte Calendar & Organiser	Productivity
jp.co.translimit.brainwars	Brain Wars	Puzzle
jp.colopl.enslingshot	SLINGSHOT BRAVES	Role Playing
jp.colopl.nyankous	Meow Meow Star Acres	Educational
jp.comico	【無料マンガ】comico/毎日新作漫画が読み放題！/コミコ	Comics
jp.gree.android.pf.greeapp58078a	Moshi Monsters Village	Simulation
jp.gree.jackpot	Jackpot Slots - Slot Machines	Casino
jp.gree.warofnationsbeta	War of Nations	Role Playing
jp.gungho.padEN	Puzzle & Dragons	Puzzle
jp.konami.swfc	Star Wars Force Collection	Strategy
jp.naver.line.android	LINE: Free Calls & Messages	Communication
jp.naver.linecamera.android	LINE camera - Selfie & Collage	Photography
jp.naver.lineplay.android	LINE PLAY	Social
jp.ne.hardyinfinity.bluelightfilter.free	Bluelight Filter for Eye Care	Health & Fitness
jp.pya.tenten.app.himatsubu	MinuteQuest	Role Playing
jp.united.app.cocoppa	icon & wallpaper CocoPPa	Personalisation
kids.math.mathforkids	Kids Math	Educational
kik.android	Kik	Communication
klb.android.lovelive_en	School idol festival	Music
kr.co.smartstudy.kidscoloringfun_android_googlemarket	Kids Coloring Fun	Education
kr.sira.measure	Smart Measure	Tools
kr.sira.unit	Unit Converter	Tools
kulana.tools.vacationcountdown	Vacation Countdown	Travel & Local
la.droid.qr	QR Droid Code Scanner	Productivity
larry.zou.colorfullife	Tool for Picasa, Google+ Photo	Social
le.lenovo.sudoku	Sudoku Free	Puzzle
letsfarm.com.playday	Let's Farm	Family
livio.pack.lang.en_US	English Dictionary - Offline	Books & Reference
livio.pack.lang.fr_FR	French Dictionary - Offline	Books & Reference
local.weather.forecast.pro	Weather Ultimate	Weather
logo.quiz.company.logosquiz.logogames.logoquiz.game.brand.quiz	Logo Quiz Perfect!	Trivia
logos.quiz.companies.game	Logo Quiz	Trivia
lunosoftware.nhlscores	NHL Scores & Alerts	Sports
mahmed.net.synctuneswirelessfree	Sync iTunes to android-windows	Music & Audio
manastone.game.wcc.Google	World Chess Championship	Board
mangatutorial.drawanime	Draw Anime - Manga tutorials	Comics
mawuoodacademy.learn.french	Learn French Speak French	Education
mdr.stocks.canada	Canadian Stock Market Watch	Finance
me.dingtone.app.im	Free Phone Calls, Free Texting	Social
me.pou.app	Pou	Casual
me.scan.android.client	QR Code Reader	Tools
media.hd.video.player	Video Player Ultimate(HD)	Media & Video
metro.mobile	My Metro	Lifestyle
mindware.mindgames	Mind Games	Puzzle
mmapps.mirror.free	Mirror	Lifestyle
mobi.avenger.game	The Avengers - destroyers	Role Playing
mobi.byss.instaweather.watchface	InstaWeather for Android Wear	Weather
mobi.infolife.ezweather	Weather Widget - EZ Weather HD	Live Wallpaper
mobi.infolife.ezweather.black	Realistic Weather Iconset HD	Weather
mobi.infolife.ezweather.iconset.solar	Beautiful 3D Weather HD Icon	Weather
mobi.infolife.ezweather.widget.black	3D Clock Weather Solid Black	Weather
mobi.infolife.ezweather.widget.elegance	Lock Screen Style Clock Widget	Weather
mobi.infolife.ezweather.widget.glass	Transparent Glass Clock Widget	Weather
mobi.infolife.ezweather.widget.googlenow	Lollipop Style Weather Widget	Weather
mobi.infolife.ezweather.widget.moto360	MotoBlur style Atrix Clock HD	Weather
mobi.infolife.ezweather.widget.oxygen	Samsung Galaxy Style Widget	Weather
mobi.infolife.ezweather.widget.sense3style	HTC Sense Style Weather Widget	Weather
mobi.infolife.ezweather.widget.symmetry	Lock Screen Clock & Weather	Weather
mobi.infolife.ezweather.widget.whiteline	Mini Line Round Clock Weather	Weather
mobi.mgeek.TunnyBrowser	Dolphin Browser for Android	Communication
mobi.net.grumpyweather	Grumpy Weather Widget	Weather
mobi.nullkm.logoquiz	Cars Logo Quiz HD	Trivia
mobile.eaudiologia	Hearing Test	Medical
monitoryourweight.bustan.net	Monitor Your Weight	Health & Fitness
net.adesignstudio.connectfour	Four In A Line	Board
net.aharm.pressed	Pressed For Words	Word
net.aljazeera.english	Al Jazeera English	News & Magazines
net.androgames.level	Bubble level	Tools
net.androidcomics.acv	A Comic Viewer	Comics
net.bigbearentertainment.android_ho_guardians	Hidden Object Mystery Guardian	Puzzle
net.daum.android.webtoon	다음 웹툰 - Daum Webtoon	Comics
net.daum.android.webtoon19	다음 웹툰(Full Ver.) -Daum Webtoon	Comics
net.elvista.checkers	Checkers Elite	Board
net.epsilonzero.hearingtest	Test Your Hearing	Medical
net.finanzen.finanzencurrencycalculator	Currency Converter	Finance
net.flixster.android	Movies by Flixster	Entertainment
net.handicrafter.games.fom	Full of Music(MP3 Rhythm Game)	Music
net.hexage.reaper	Reaper	Role Playing
net.HypercraftSarl.WCMF	World of Craft: Mine Forest	Adventure
net.idt.um.android.bossrevapp.ca	BOSS Revolution CA	Communication
net.jeu.solitaire	Solitaire	Card
net.jeu.spider	Spider Solitaire	Card
net.kervala.comicsreader	Comics Reader	Comics
net.mobilecraft.flickshoot2	Flick Shoot 2	Sports
net.mobilecraft.football	Flick Shoot (Soccer Football)	Sports
net.mobilecraft.mushboom	Mushboom	Adventure
net.mobilecraft.realbasketball	Real Basketball	Sports
net.p4p.absen	8 Minutes Abs Workout	Health & Fitness
net.p4p.buttocks	Butt Workout	Health & Fitness
net.peakgames.mobile.android.tavlaplus.android	Backgammon Plus	Board
net.peakgames.mobile.rummi.android	Rummi Plus	Board
net.peakgames.mobile.spades.android	Spades Plus	Card
net.playq.charmking	Charm King	Puzzle
net.ReferyGames.TC2JM	Tropical Craft 2: Jungle Mine	Adventure
net.ReferyGames.WC2WW	Western Craft 2: Wild West	Adventure
net.SandStormEarl.CC2	City Craft 2: TNT & Clowns	Adventure
net.SandStormEarl.MCTB	Medieval Craft: Town Building	Adventure
net.skyscanner.android.main	Skyscanner - All Flights!	Travel & Local
net.slideshare.mobile	SlideShare Presentations	Media & Video
net.wargaming.wot.blitz	World of Tanks Blitz	Action
net.xelnaga.exchanger	Exchange Rates	Finance
net.yura.domination	Domination (strategy and risk)	Board
net.zedge.android	ZEDGE™ Ringtones & Wallpapers	Widgets
net.zhuoweizhang.mcpelauncher	BlockLauncher	Tools
nextapp.fx	File Explorer	Business
nhlquiz.william	Sports Logo Quiz Hockey	Trivia
nl.itchmedia.riddlemethat	Riddle Me That	Word
opl.textc	Transit Now Toronto for TTC	Transport
org.androidworks.livewallpaperwatervr	Lanterns for Google Cardboard	Libraries & Demo
org.androidworks.villagevr.villagevr	Cartoon Village VR	Libraries & Demo
org.boxtrolls.fingerslash	Finger Slash - Cut your Finger	Arcade
org.coolreader	Cool Reader	Books & Reference
org.coursera.android	Coursera - Learn Programming	Education
org.dayup.stocks	Stocks - Realtime Stock Quotes	Finance
org.hola	Hola Free VPN	Tools
org.icemint.princess.frozen.online	T-Puzzle: Frozen Princess	Educational
org.jw.jwlibrary.mobile	JW Library	Books & Reference
org.kde.necessitas.ministro	Ministro II	Libraries & Demo
org.kill.geek.bdviewer	Challenger Comics Viewer	Comics
org.leetzone.android.yatsewidgetfree	Yatse, the XBMC / Kodi Remote	Media & Video
org.medhelp.mc	My Cycles Period and Ovulation	Health & Fitness
org.mozilla.firefox	Firefox Browser for Android	Communication
org.mrchops.android.digihud	DigiHUD Speedometer	Transport
org.msq.babygames	Baby Games	Educational
org.opencv.engine	OpenCV Manager	Libraries & Demo
org.orangenose.games	Hardest Game Ever 2	Casual
org.rbc.odb	Our Daily Bread	Books & Reference
org.stopbreathethink.app	Stop, Breathe & Think	Health & Fitness
org.telegram.messenger	Telegram	Communication
org.torproject.android	Orbot: Proxy with Tor	Communication
org.videolan.vlc.betav7neon	VLC for Android beta	Widgets
org.wikipedia	Wikipedia	Books & Reference
org.withouthat.acalendar	aCalendar - Android Calendar	Productivity
org.wordpress.android	WordPress	Social
org.xssembler.chordsplus	Guitar chords and tabs	Music & Audio
org.yccheok.jstock.gui	JStock Android - Stock Market	Finance
org.zwanoo.android.speedtest	Speedtest.net	Tools
paravozickgroup.ua.batmanflashlight	Batman Flashlight	Comics
pdf.reader	PDF Reader	Books & Reference
photo.android.hd.camera	HD Camera for Android	Photography
pl.extremedia.diagnozer	Pregnancy Test Dr Diagnozer	Medical
pl.idreams.skyforcehd	Sky Force 2014	Arcade
pl.infinzmedia.electricscreenfree	Electric Screen Live Wallpaper	Personalisation
pl.kidsgameprojects.com.AnimalsFarmForKids	Animals Farm For Kids	Educational
polis.app.callrecorder	Call Recorder	Communication
quess.song.music.pop.quiz	Guess The Song	Trivia
ru.grocerylist.android	Shopping List	Shopping
ru.nsu.ccfit.zuev.osu	osu!droid	Music
se.feomedia.quizkampen.fr.lite	Duel Quiz	Trivia
se.illusionlabs.bmx	Touchgrind BMX	Sports
se.maginteractive.rumble.free	Ruzzle Free	Word
se.maginteractive.ruzzleadventure	Ruzzle Adventure	Word
se.maginteractive.ruzzlewordgenius	Ruzzle: Word Genius	Word
se.perigee.android.seven	7 Minute Workout "Seven"	Health & Fitness
sg.gumi.bravefrontier	Brave Frontier	Action
sg.gumi.chainchronicleglobal	Chain Chronicle – RPG	Role Playing
sh.whisper	Whisper	Social
si.modula.android.instantheartrate	Instant Heart Rate	Widgets
sk.halmi.itimerad	Interval Timer 4 HIIT Training	Sports
sumas.jocmania	sums for children	Educational
supercontraption.android	Super Contraption	Simulation
surebaby.pregnancy.calculator	Pregnancy Due Date Calculator	Medical
thecouponsapp.coupon	The Coupons App	Shopping
thehunt.shoptap.thehunt	The Hunt - Shopping Q&A	Shopping
thinkcube.project23	What am I? - Little Riddles	Word
triangleSoftware.traffic.android	Beat the Traffic	Travel & Local
tunein.player	TuneIn Radio	Widgets
tv.danmaku.bili	哔哩哔哩动画	Comics
tv.tou.android	ICI Tou.tv	Entertainment
tv.twitch.android.viewer	Twitch	Entertainment
tv.ustream.ustream	Ustream	Media & Video
ua.paravozickgroup.batman	Batman	Role Playing
uk.co.aifactory.backgammonfree	Backgammon Free	Board
uk.co.aifactory.checkersfree	Checkers Free	Board
uk.co.aifactory.chessfree	Chess Free	Board
uk.co.aifactory.euchrefree	Euchre Free	Card
uk.co.aifactory.fialfree	Four In A Line Free	Board
uk.co.aifactory.ginrummyfree	Gin Rummy Free	Card
uk.co.aifactory.heartsfree	Hearts Free	Card
uk.co.aifactory.moveitfree	Move it! Free - Block puzzle	Board
uk.co.aifactory.rrfree	Reversi Free	Board
uk.co.aifactory.solitairefree	Solitaire Free	Card
uk.co.aifactory.spadesfree	Spades Free	Card
uk.co.aifactory.sudokufree	Sudoku Free	Board
uk.co.economist	The Economist	News & Magazines
uk.co.jads.android.jpc	JPC x86 (DOS)	Libraries & Demo
uk.co.kempt.KartFighter3	Red Bull Kart Fighter 3	Racing
uk.co.nickfines.RealCalc	RealCalc Scientific Calculator	Productivity
uk.co.sgem.celebrityquiz	Celebrity Quiz	Trivia
unity.enjen.scooter	Scooter Freestyle Extreme 3D	Sports
us.kick9.k3000000008.c3101000001	NBA All Net	Sports
us.mathlab.android	Graphing Calculator by Mathlab	Education
us.porrassoft.xray	Xray Scanner Prank	Entertainment
vivino.web.app	Vivino Wine Scanner	Lifestyle
vn.sieuweb.tamngon3	Spelling for children	Educational
vspringboard.cpha.activity	RxTx Mobile	Medical
vStudio.Android.Camera360	Camera360 Ultimate	Photography
wb.receipts	Smart Receipts	Finance
wp.wattpad	Wattpad - Free Books & Ebooks	Books & Reference
ws.letras	Word Search	Word
xray.ruocco	Xray Prank	Casual
yo.app.free	YoWindow Free Weather	Weather
younow.live	YouNow: Broadcast, Watch, Chat	Social
your.CouponFinder.CouponFinder	Extreme Coupon Finder	Shopping
zok.android.dots	Toddlers Connect the Dots Lite	Educational
zok.android.letters	Toddler Games Free Educational	Educational
zok.android.numbers	Learning Games: Toddler Math	Educational
zok.android.phonics	Learn Phonics - ABCs Preschool	Educational
zok.android.shapes	Games for Toddlers: Puzzles	Educational
zoom.authentic.surgerygames	Surgery Games	Role Playing
